अ	अ |
अंगीकृतवान्	अ ं ग ी क ृ त व ा न ् |
अंजाप्रान्तः	अ ं ज ा प ् र ा न ् त ः |
अंतिम्	अ ं त ि म ् |
अकबरुद्दीनः	अ क ब र ु द ् द ी न ः |
अकरणे	अ क र ण े |
अकामयत्	अ क ा म य त ् |
अकारणं	अ क ा र ण ं |
अकारणमेव	अ क ा र ण म े व |
अकुर्वन्	अ क ु र ् व न ् |
अकुर्वन्निति	अ क ु र ् व न ् न ि त ि |
अक्षशौण्डं	अ क ् ष श ौ ण ् ड ं |
अखिल	अ ख ि ल |
अग्	अ ग ् |
अग्निं	अ ग ् न ि ं |
अग्निः	अ ग ् न ि ः |
अग्निचयन	अ ग ् न ि च य न |
अग्निमेवदेवतानां	अ ग ् न ि म े व द े व त ा न ा ं |
अग्निरिति	अ ग ् न ि र ि त ि |
अग्निरुत्पन्नः	अ ग ् न ि र ु त ् प न ् न ः |
अग्निरेव	अ ग ् न ि र े व |
अग्निर्जातः	अ ग ् न ि र ् ज ा त ः |
अग्निर्नम	अ ग ् न ि र ् न म |
अग्निहोत्र	अ ग ् न ि ह ो त ् र |
अग्निहोत्रं	अ ग ् न ि ह ो त ् र ं |
अग्निहोत्रकरणेन	अ ग ् न ि ह ो त ् र क र ण े न |
अग्निहोत्रब्राह्मणमात्रं	अ ग ् न ि ह ो त ् र ब ् र ा ह ् म ण म ा त ् र ं |
अग्निहोत्रादीनां	अ ग ् न ि ह ो त ् र ा द ी न ा ं |
अग्निहोत्राहुतिपरिणामात्मकं	अ ग ् न ि ह ो त ् र ा ह ु त ि प र ि ण ा म ा त ् म क ं |
अग्निहोत्रे	अ ग ् न ि ह ो त ् र े |
अग्नीषोमात्मकं	अ ग ् न ी ष ो म ा त ् म क ं |
अग्नीषोमात्मिका	अ ग ् न ी ष ो म ा त ् म ि क ा |
अग्नीषोमौ	अ ग ् न ी ष ो म ौ |
अग्नीषौमीय	अ ग ् न ी ष ौ म ी य |
अग्ने	अ ग ् न े |
अग्नेः	अ ग ् न े ः |
अग्नेरुत्पन्नत्वं	अ ग ् न े र ु त ् प न ् न त ् व ं |
अग्नेस्स्वरूपं	अ ग ् न े स ् स ् व र ू प ं |
अग्नौ	अ ग ् न ौ |
अग्नौस्	अ ग ् न ौ स ् |
अग्रवर्तीनि	अ ग ् र व र ् त ी न ि |
अग्रिमं	अ ग ् र ि म ं |
अग्रिमद्वित्रिसप्ताहं	अ ग ् र ि म द ् व ि त ् र ि स प ् त ा ह ं |
अग्रिमसूत्रं	अ ग ् र ि म स ू त ् र ं |
अग्रिष्टोमः	अ ग ् र ि ष ् ट ो म ः |
अग्रे	अ ग ् र े |
अग्रेसरति	अ ग ् र े स र त ि |
अग्रेसारयितुं	अ ग ् र े स ा र य ि त ु ं |
अग्रोहोत्रं	अ ग ् र ो ह ो त ् र ं |
अघटनायाः	अ घ ट न ा य ा ः |
अङ्कत्रयेण	अ ङ ् क त ् र य े ण |
अङ्केन	अ ङ ् क े न |
अङ्केनैकेन	अ ङ ् क े न ै क े न |
अङ्गिरसो	अ ङ ् ग ि र स ो |
अङ्गीकरोति	अ ङ ् ग ी क र ो त ि |
अङ्गीकारः	अ ङ ् ग ी क ा र ः |
अङ्गीकारेण	अ ङ ् ग ी क ा र े ण |
अङ्गीकृतवान्	अ ङ ् ग ी क ृ त व ा न ् |
अच्युतः	अ च ् य ु त ः |
अजयरायं	अ ज य र ा य ं |
अजीतडोभालवर्येण	अ ज ी त ड ो भ ा ल व र ् य े ण |
अटामि	अ ट ा म ि |
अटारीवाघासंयुक्तनिरीक्षणस्थले	अ ट ा र ी व ा घ ा स ं य ु क ् त न ि र ी क ् ष ण स ् थ ल े |
अत	अ त |
अतः	अ त ः |
अतःसर्वेषा	अ त ः स र ् व े ष ा |
अतिक्रम	अ त ि क ् र म |
अतिक्रमणं	अ त ि क ् र म ण ं |
अतिक्रमणेन	अ त ि क ् र म ण े न |
अतिक्रम्य	अ त ि क ् र म ् य |
अतितरां	अ त ि त र ा ं |
अतितराम्	अ त ि त र ा म ् |
अतिदूरं	अ त ि द ू र ं |
अतिरात्रः	अ त ि र ा त ् र ः |
अतिरिक्तनिदेशकरूपेण	अ त ि र ि क ् त न ि द े श क र ू प े ण |
अतिरिक्तप्रभारिदायित्वं	अ त ि र ि क ् त प ् र भ ा र ि द ा य ि त ् व ं |
अतिरिक्तावधिम्	अ त ि र ि क ् त ा व ध ि म ् |
अतिरिक्तैः	अ त ि र ि क ् त ै ः |
अतिविपुलस्य	अ त ि व ि प ु ल स ् य |
अतिविशिष्टजनोपयोगिउदग्रयानप्रवञ्चनाप्रकरणस्य	अ त ि व ि श ि ष ् ट ज न ो प य ो ग ि उ द ग ् र य ा न प ् र व ञ ् च न ा प ् र क र ण स ् य |
अतिवृष्टि	अ त ि व ृ ष ् ट ि |
अतीव	अ त ी व |
अत्यग्रिष्टोमः	अ त ् य ग ् र ि ष ् ट ो म ः |
अत्यजत्	अ त ् य ज त ् |
अत्यवधानमत्र	अ त ् य व ध ा न म त ् र |
अत्र	अ त ् र |
अत्रान्तरे	अ त ् र ा न ् त र े |
अत्रापि	अ त ् र ा प ि |
अत्राभिहितम्	अ त ् र ा भ ि ह ि त म ् |
अत्रावसरे	अ त ् र ा व स र े |
अथ	अ थ |
अथः	अ थ ः |
अथवा	अ थ व ा |
अथा	अ थ ा |
अथातः	अ थ ा त ः |
अदर्श	अ द र ् श |
अदृ	अ द ृ |
अदोषा	अ द ो ष ा |
अद्य	अ द ् य |
अद्यापराह्णे	अ द ् य ा प र ा ह ् ण े |
अधावत्	अ ध ा व त ् |
अधासनशायी	अ ध ा स न श ा य ी |
अधिक	अ ध ि क |
अधिकतर्	अ ध ि क त र ् |
अधिकतास्ति	अ ध ि क त ा स ् त ि |
अधिकरोति	अ ध ि क र ो त ि |
अधिकाधिकं	अ ध ि क ा ध ि क ं |
अधिकारः	अ ध ि क ा र ः |
अधिकारक्षेत्रे	अ ध ि क ा र क ् ष े त ् र े |
अधिकारान्तर्गतं	अ ध ि क ा र ा न ् त र ् ग त ं |
अधिकारिणां	अ ध ि क ा र ि ण ा ं |
अधिकारिणो	अ ध ि क ा र ि ण ो |
अधिकारिभिः	अ ध ि क ा र ि भ ि ः |
अधिकारोवर्तते	अ ध ि क ा र ो व र ् त त े |
अधिकृत	अ ध ि क ृ त |
अधिकृतमन्त्रि	अ ध ि क ृ त म न ् त ् र ि |
अधिकृतवक्तव्ये	अ ध ि क ृ त व क ् त व ् य े |
अधिकृतैःस्रोतोभिः	अ ध ि क ृ त ै ः स ् र ो त ो भ ि ः |
अधिकृत्य	अ ध ि क ृ त ् य |
अधिकैक	अ ध ि क ै क |
अधिगतम्	अ ध ि ग त म ् |
अधिगतवन्तः	अ ध ि ग त व न ् त ः |
अधिगतवान्	अ ध ि ग त व ा न ् |
अधिगता	अ ध ि ग त ा |
अधिगत्यानि	अ ध ि ग त ् य ा न ि |
अधिगन्तुं	अ ध ि ग न ् त ु ं |
अधिगमन्	अ ध ि ग म न ् |
अधिगम्य	अ ध ि ग म ् य |
अधिगृहीतम्	अ ध ि ग ृ ह ी त म ् |
अधिवक्तृणां	अ ध ि व क ् त ृ ण ा ं |
अधिवेशनम्	अ ध ि व े श न म ् |
अधीतवेदास्सन्ति	अ ध ी त व े द ा स ् स न ् त ि |
अधीष्व	अ ध ी ष ् व |
अधुना	अ ध ु न ा |
अधुनापि	अ ध ु न ा प ि |
अधुनावधि	अ ध ु न ा व ध ि |
अध्यक्षः	अ ध ् य क ् ष ः |
अध्यक्षपदार्थं	अ ध ् य क ् ष प द ा र ् थ ं |
अध्यक्षपदार्थम्	अ ध ् य क ् ष प द ा र ् थ म ् |
अध्यक्षयति	अ ध ् य क ् ष य त ि |
अध्यगच्छत्	अ ध ् य ग च ् छ त ् |
अध्ययं	अ ध ् य य ं |
अध्ययनं	अ ध ् य य न ं |
अध्ययनपरंपरा	अ ध ् य य न प र ं प र ा |
अध्ययनस्य	अ ध ् य य न स ् य |
अध्ययनाधीनं	अ ध ् य य न ा ध ी न ं |
अध्यर्थना	अ ध ् य र ् थ न ा |
अध्यर्थनां	अ ध ् य र ् थ न ा ं |
अध्यर्थनापत्रस्य	अ ध ् य र ् थ न ा प त ् र स ् य |
अध्यर्थयिष्यति	अ ध ् य र ् थ य ि ष ् य त ि |
अध्यर्थितम्	अ ध ् य र ् थ ि त म ् |
अध्यर्थित्वत्	अ ध ् य र ् थ ि त ् व त ् |
अध्यात्मयोगाः	अ ध ् य ा त ् म य ो ग ा ः |
अध्यात्मयोगान्	अ ध ् य ा त ् म य ो ग ा न ् |
अध्यार्थयत्	अ ध ् य ा र ् थ य त ् |
अध्याहं	अ ध ् य ा ह ं |
अध्येतारश्च	अ ध ् य े त ा र श ् च |
अध्येतृणाञ्च	अ ध ् य े त ृ ण ा ञ ् च |
अनन्तरं	अ न न ् त र ं |
अनन्तरम्	अ न न ् त र म ् |
अनयोः	अ न य ो ः |
अनाग्निहोत्रितायाः	अ न ा ग ् न ि ह ो त ् र ि त ा य ा ः |
अनारंभश्चेत्	अ न ा र ं भ श ् च े त ् |
अनारतं	अ न ा र त ं |
अनाश्रमी	अ न ा श ् र म ी |
अनियमः	अ न ि य म ः |
अनियमयः	अ न ि य म य ः |
अनिर्णीता	अ न ि र ् ण ी त ा |
अनिवार्या	अ न ि व ा र ् य ा |
अनुकूलयितुं	अ न ु क ू ल य ि त ु ं |
अनुकूला	अ न ु क ू ल ा |
अनुक्रमं	अ न ु क ् र म ं |
अनुजिघृक्या	अ न ु ज ि घ ृ क ् य ा |
अनुज्ञातवान्	अ न ु ज ् ञ ा त व ा न ् |
अनुज्ञाप्रदाने	अ न ु ज ् ञ ा प ् र द ा न े |
अनुतिष्ठता	अ न ु त ि ष ् ठ त ा |
अनुतिष्ठेत्	अ न ु त ि ष ् ठ े त ् |
अनुपालनार्थं	अ न ु प ा ल न ा र ् थ ं |
अनुपालयितुं	अ न ु प ा ल य ि त ु ं |
अनुभवन्ति	अ न ु भ व न ् त ि |
अनुभूयते	अ न ु भ ू य त े |
अनुमतिं	अ न ु म त ि ं |
अनुमतेः	अ न ु म त े ः |
अनुमानमपि	अ न ु म ा न म प ि |
अनुमानितः	अ न ु म ा न ि त ः |
अनुमाने	अ न ु म ा न े |
अनुवर्तते	अ न ु व र ् त त े |
अनुवर्तमानां	अ न ु व र ् त म ा न ा ं |
अनुवर्तमाने	अ न ु व र ् त म ा न े |
अनुवर्तितुम्	अ न ु व र ् त ि त ु म ् |
अनुषंगेण	अ न ु ष ं ग े ण |
अनुष्ठातुम्	अ न ु ष ् ठ ा त ु म ् |
अनुष्ठान	अ न ु ष ् ठ ा न |
अनुष्ठानं	अ न ु ष ् ठ ा न ं |
अनुष्ठानंविना	अ न ु ष ् ठ ा न ं व ि न ा |
अनुष्ठास्यति	अ न ु ष ् ठ ा स ् य त ि |
अनुष्ठास्यते	अ न ु ष ् ठ ा स ् य त े |
अनुष्ठीयन्ते	अ न ु ष ् ठ ी य न ् त े |
अनुष्ठीयन्तेसर्वान्यपि	अ न ु ष ् ठ ी य न ् त े स र ् व ा न ् य प ि |
अनुष्ठेयाः	अ न ु ष ् ठ े य ा ः |
अनुसंधानमेतन्	अ न ु स ं ध ा न म े त न ् |
अनुसारि	अ न ु स ा र ि |
अनुसृत्य	अ न ु स ृ त ् य |
अनेकान्	अ न े क ा न ् |
अनेके	अ न े क े |
अनेकेषु	अ न े क े ष ु |
अनेकैः	अ न े क ै ः |
अनेनहेतुना	अ न े न ह े त ु न ा |
अनैव	अ न ै व |
अन्तरास्ट्रिय	अ न ् त र ा स ् ट ् र ि य |
अन्तरिक्षवैज्ञानिकाः	अ न ् त र ि क ् ष व ै ज ् ञ ा न ि क ा ः |
अन्तर्जाले	अ न ् त र ् ज ा ल े |
अन्तर्यामिब्राह्मणे	अ न ् त र ् य ा म ि ब ् र ा ह ् म ण े |
अन्ताराष्ट्रिय	अ न ् त ा र ा ष ् ट ् र ि य |
अन्ताराष्ट्रियाश्च	अ न ् त ा र ा ष ् ट ् र ि य ा श ् च |
अन्तिम	अ न ् त ि म |
अन्तिमे	अ न ् त ि म े |
अन्तिमो	अ न ् त ि म ो |
अन्त्यचक्रं	अ न ् त ् य च क ् र ं |
अन्त्यद्वन्द्वे	अ न ् त ् य द ् व न ् द ् व े |
अन्धकारे	अ न ् ध क ा र े |
अन्नं	अ न ् न ं |
अन्नमपि	अ न ् न म प ि |
अन्नम्	अ न ् न म ् |
अन्नात्प्राणोमनस्सत्यं	अ न ् न ा त ् प ् र ा ण ो म न स ् स त ् य ं |
अन्नादः	अ न ् न ा द ः |
अन्य	अ न ् य |
अन्यः	अ न ् य ः |
अन्यच्च	अ न ् य च ् च |
अन्यतमं	अ न ् य त म ं |
अन्यतमः	अ न ् य त म ः |
अन्यतमग्रामे	अ न ् य त म ग ् र ा म े |
अन्यतमम्	अ न ् य त म म ् |
अन्यतमे	अ न ् य त म े |
अन्यतमो	अ न ् य त म ो |
अन्यत्र	अ न ् य त ् र |
अन्यसूत्रेषु	अ न ् य स ू त ् र े ष ु |
अन्याय्यञ्ज	अ न ् य ा य ् य ञ ् ज |
अन्याश्च	अ न ् य ा श ् च |
अन्ये	अ न ् य े |
अन्येपि	अ न ् य े प ि |
अन्येभ्यः	अ न ् य े भ ् य ः |
अन्येषां	अ न ् य े ष ा ं |
अन्यैश्च	अ न ् य ै श ् च |
अन्योन्यं	अ न ् य ो न ् य ं |
अन्वाघारादीनि	अ न ् व ा घ ा र ा द ी न ि |
अन्वीक्षणं	अ न ् व ी क ् ष ण ं |
अन्वीक्षणसन्दर्भे	अ न ् व ी क ् ष ण स न ् द र ् भ े |
अन्वीक्षणानन्तरं	अ न ् व ी क ् ष ण ा न न ् त र ं |
अन्वीक्षणार्थम्	अ न ् व ी क ् ष ण ा र ् थ म ् |
अन्वीक्षितुं	अ न ् व ी क ् ष ि त ु ं |
अन्वेषण	अ न ् व े ष ण |
अन्वेषणानि	अ न ् व े ष ण ा न ि |
अपकीर्तयितुं	अ प क ी र ् त य ि त ु ं |
अपचाय्य	अ प च ा य ् य |
अपचितम्	अ प च ि त म ् |
अपचीयमाना	अ प च ी य म ा न ा |
अपरतो	अ प र त ो |
अपरपक्षस्य	अ प र प क ् ष स ् य |
अपरपक्षे	अ प र प क ् ष े |
अपरपक्ष्य	अ प र प क ् ष ् य |
अपरपराधी	अ प र प र ा ध ी |
अपरस्यां	अ प र स ् य ा ं |
अपराह्ण	अ प र ा ह ् ण |
अपराह्णः	अ प र ा ह ् ण ः |
अपरे	अ प र े |
अपरेषण्णवतिश्च	अ प र े ष ण ् ण व त ि श ् च |
अपरेषु	अ प र े ष ु |
अपरो	अ प र ो |
अपर्णा	अ प र ् ण ा |
अपवर्गः	अ प व र ् ग ः |
अपवादः	अ प व ा द ः |
अपवादार्थं	अ प व ा द ा र ् थ ं |
अपहत	अ प ह त |
अपहृतानां	अ प ह ृ त ा न ा ं |
अपह्र्तानां	अ प ह ् र ् त ा न ा ं |
अपाकरणमनुसृत्य	अ प ा क र ण म न ु स ृ त ् य |
अपाकर्तुं	अ प ा क र ् त ु ं |
अपाकारणम्	अ प ा क ा र ण म ् |
अपाकृत्य	अ प ा क ृ त ् य |
अपानेजुह्वति	अ प ा न े ज ु ह ् व त ि |
अपि	अ प ि |
अपिसर्वज्ञौ	अ प ि स र ् व ज ् ञ ौ |
अपुत्रीकः	अ प ु त ् र ी क ः |
अपूर्वः	अ प ू र ् व ः |
अपेक्षते	अ प े क ् ष त े |
अपेक्षन्ते	अ प े क ् ष न ् त े |
अपेक्षां	अ प े क ् ष ा ं |
अपेक्षिकं	अ प े क ् ष ि क ं |
अपेक्षिता	अ प े क ् ष ि त ा |
अपोद्यामहे	अ प ो द ् य ा म ह े |
अप्तोर्याः	अ प ् त ो र ् य ा ः |
अप्रचलितान्	अ प ् र च ल ि त ा न ् |
अप्रमापीकरणविषये	अ प ् र म ा प ी क र ण व ि ष य े |
अप्रसारसन्धेः	अ प ् र स ा र स न ् ध े ः |
अप्राप्तं	अ प ् र ा प ् त ं |
अप्राप्तविधिं	अ प ् र ा प ् त व ि ध ि ं |
अप्राप्तविधिः	अ प ् र ा प ् त व ि ध ि ः |
अप्रिय	अ प ् र ि य |
अफ़गानिस्तानस्य	अ फ ़ ग ा न ि स ् त ा न स ् य |
अफ़गानिस्ताने	अ फ ़ ग ा न ि स ् त ा न े |
अफ़्गानिस्तानशरणार्थिनः	अ फ ़ ् ग ा न ि स ् त ा न श र ण ा र ् थ ि न ः |
अफ़्गानिस्तानस्य	अ फ ़ ् ग ा न ि स ् त ा न स ् य |
अफ़्गानिस्ताने	अ फ ़ ् ग ा न ि स ् त ा न े |
अफ़्गान्सैनिकेन	अ फ ़ ् ग ा न ् स ै न ि क े न |
अबूकोशाइति	अ ब ू क ो श ा इ त ि |
अबूहंसाइतिउग्र	अ ब ू ह ं स ा इ त ि उ ग ् र |
अबे	अ ब े |
अब्दुल्सुभाननामकः	अ ब ् द ु ल ् स ु भ ा न न ा म क ः |
अब्दुल्हसन्महमूदअली	अ ब ् द ु ल ् ह स न ् म ह म ू द अ ल ी |
अब्रवीत्	अ ब ् र व ी त ् |
अभयानं	अ भ य ा न ं |
अभयारण्यस्य	अ भ य ा र ण ् य स ् य |
अभवत्	अ भ व त ् |
अभाणीत्	अ भ ा ण ी त ् |
अभाषत्	अ भ ा ष त ् |
अभिघोषणां	अ भ ि घ ो ष ण ा ं |
अभिघोषितम्	अ भ ि घ ो ष ि त म ् |
अभिघोषितवत्	अ भ ि घ ो ष ि त व त ् |
अभिनन्दितः	अ भ ि न न ् द ि त ः |
अभिनन्दितवान्	अ भ ि न न ् द ि त व ा न ् |
अभिनन्दिताः	अ भ ि न न ् द ि त ा ः |
अभिनव	अ भ ि न व |
अभिनवं	अ भ ि न व ं |
अभिनवत्वेन	अ भ ि न व त ् व े न |
अभिनवप्रशासनस्य	अ भ ि न व प ् र श ा स न स ् य |
अभिनवसंस्थानस्य	अ भ ि न व स ं स ् थ ा न स ् य |
अभिनवाः	अ भ ि न व ा ः |
अभिप्रायः	अ भ ि प ् र ा य ः |
अभिभाषते	अ भ ि भ ा ष त े |
अभियन्तृ	अ भ ि य न ् त ृ |
अभियाचना	अ भ ि य ा च न ा |
अभियाचनाम्	अ भ ि य ा च न ा म ् |
अभियाचन्ते	अ भ ि य ा च न ् त े |
अभियानानि	अ भ ि य ा न ा न ि |
अभियोजन	अ भ ि य ो ज न |
अभिलक्ष्य	अ भ ि ल क ् ष ् य |
अभिलेखितम्	अ भ ि ल े ख ि त म ् |
अभिव्यज्यते	अ भ ि व ् य ज ् य त े |
अभिस्वीकृतम्	अ भ ि स ् व ी क ृ त म ् |
अभिहितम्	अ भ ि ह ि त म ् |
अभूतपूर्वां	अ भ ू त प ू र ् व ा ं |
अभूत्	अ भ ू त ् |
अभ्यर्थिजनान्	अ भ ् य र ् थ ि ज न ा न ् |
अभ्युदयं	अ भ ् य ु द य ं |
अभ्युपगतः	अ भ ् य ु प ग त ः |
अभ्युपागच्छत्	अ भ ् य ु प ा ग च ् छ त ् |
अमरनाथ	अ म र न ा थ |
अमावास्यायां	अ म ा व ा स ् य ा य ा ं |
अमिलत्	अ म ि ल त ् |
अमुना	अ म ु न ा |
अमेरिका	अ म े र ि क ा |
अमेरिकादेशीयविदेशमन्त्री	अ म े र ि क ा द े श ी य व ि द े श म न ् त ् र ी |
अमेरिकादेशीयैः	अ म े र ि क ा द े श ी य ै ः |
अमेरिकाया	अ म े र ि क ा य ा |
अमेरिकाराष्ट्रपतिः	अ म े र ि क ा र ा ष ् ट ् र प त ि ः |
अमेरिकीय	अ म े र ि क ी य |
अमेरिकीयः	अ म े र ि क ी य ः |
अमेरिकीयो	अ म े र ि क ी य ो |
अम्बाटीरायुडूः	अ म ् ब ा ट ी र ा य ु ड ू ः |
अम्बालाराजमार्गक्षेत्रात्	अ म ् ब ा ल ा र ा ज म ा र ् ग क ् ष े त ् र ा त ् |
अम्बुदय	अ म ् ब ु द य |
अम्बेगाव्उपविभागे	अ म ् ब े ग ा व ् उ प व ि भ ा ग े |
अयज्ञ	अ य ज ् ञ |
अयुजोभागाः	अ य ु ज ो भ ा ग ा ः |
अयुध्यत	अ य ु ध ् य त |
अरण्यात्	अ र ण ् य ा त ् |
अरण्येषु	अ र ण ् य े ष ु |
अरनियाआर्एस्पुराक्षेत्रयो	अ र न ि य ा आ र ् ए स ् प ु र ा क ् ष े त ् र य ो |
अरविन्द	अ र व ि न ् द |
अरुण	अ र ु ण |
अरुणजेटलिना	अ र ु ण ज े ट ल ि न ा |
अरुणजेटली	अ र ु ण ज े ट ल ी |
अरुणजेटलीम्	अ र ु ण ज े ट ल ी म ् |
अरुणाचलप्रदेशयोः	अ र ु ण ा च ल प ् र द े श य ो ः |
अरूण	अ र ू ण |
अर्चनारामासुन्दरम्	अ र ् च न ा र ा म ा स ु न ् द र म ् |
अर्जुनः	अ र ् ज ु न ः |
अर्थ	अ र ् थ |
अर्थः	अ र ् थ ः |
अर्थज्ञानपर्यन्तं	अ र ् थ ज ् ञ ा न प र ् य न ् त ं |
अर्थज्ञानम्	अ र ् थ ज ् ञ ा न म ् |
अर्थज्ञानायत्तं	अ र ् थ ज ् ञ ा न ा य त ् त ं |
अर्थबोधो	अ र ् थ ब ो ध ो |
अर्थसंकल्प	अ र ् थ स ं क ल ् प |
अर्थापगमे	अ र ् थ ा प ग म े |
अर्धपिप्पली	अ र ् ध प ि प ् प ल ी |
अर्नियेतिउपक्षेत्रे	अ र ् न ि य े त ि उ प क ् ष े त ् र े |
अर्पयिष्यति	अ र ् प य ि ष ् य त ि |
अर्पितः	अ र ् प ि त ः |
अर्हति	अ र ् ह त ि |
अलंकरिष्यति	अ ल ं क र ि ष ् य त ि |
अलङ्करिष्यति	अ ल ङ ् क र ि ष ् य त ि |
अलिं	अ ल ि ं |
अल्ज़ीरिया	अ ल ् ज ़ ी र ि य ा |
अल्ज़ीरियाराष्ट्रियविमानप्राधिकरणेन	अ ल ् ज ़ ी र ि य ा र ा ष ् ट ् र ि य व ि म ा न प ् र ा ध ि क र ण े न |
अल्जीरियारशियादेशयोः	अ ल ् ज ी र ि य ा र श ि य ा द े श य ो ः |
अवकाश	अ व क ा श |
अवक्ष्यति	अ व क ् ष ् य त ि |
अवगमार्थं	अ व ग म ा र ् थ ं |
अवगमे	अ व ग म े |
अवचित्य	अ व च ि त ् य |
अवधानतायुक्तस्य	अ व ध ा न त ा य ु क ् त स ् य |
अवधिं	अ व ध ि ं |
अवरुद्धभारतीयान्	अ व र ु द ् ध भ ा र त ी य ा न ् |
अवरुद्धानां	अ व र ु द ् ध ा न ा ं |
अवरुद्धानाम्	अ व र ु द ् ध ा न ा म ् |
अवरुन्धे	अ व र ु न ् ध े |
अवरोद्धुं	अ व र ो द ् ध ु ं |
अवरोधः	अ व र ो ध ः |
अवर्गीयस्पर्धायां	अ व र ् ग ी य स ् प र ् ध ा य ा ं |
अवर्णयत्	अ व र ् ण य त ् |
अवर्तत	अ व र ् त त |
अवर्तन्त	अ व र ् त न ् त |
अवलम्ब्य	अ व ल म ् ब ् य |
अवलोक्य	अ व ल ो क ् य |
अवशिष्टं	अ व श ि ष ् ट ं |
अवशिष्टाः	अ व श ि ष ् ट ा ः |
अवशिष्टानां	अ व श ि ष ् ट ा न ा ं |
अवशिष्टे	अ व श ि ष ् ट े |
अवशिष्टौ	अ व श ि ष ् ट ौ |
अवश्य	अ व श ् य |
अवश्यं	अ व श ् य ं |
अवश्यमनुष्ठेयाः	अ व श ् य म न ु ष ् ठ े य ा ः |
अवसरे	अ व स र े |
अवस्थितः	अ व स ् थ ि त ः |
अवस्थिते	अ व स ् थ ि त े |
अवादीत्	अ व ा द ी त ् |
अवाप्त्यर्थं	अ व ा प ् त ् य र ् थ ं |
अवाप्य	अ व ा प ् य |
अवाप्स्यति	अ व ा प ् स ् य त ि |
अवाप्स्यते	अ व ा प ् स ् य त े |
अवारुन्ध	अ व ा र ु न ् ध |
अविच्छेद	अ व ि च ् छ े द |
अविद्यता	अ व ि द ् य त ा |
अवैध	अ व ै ध |
अवोचत्	अ व ो च त ् |
अव्याकुतमपि	अ व ् य ा क ु त म प ि |
अव्याकुतात्	अ व ् य ा क ु त ा त ् |
अव्याकृतं	अ व ् य ा क ृ त ं |
अव्याकृतमं	अ व ् य ा क ृ त म ं |
अव्याकृतात्	अ व ् य ा क ृ त ा त ् |
अव्य्	अ व ् य ् |
अशीतिमिनटावधिके	अ श ी त ि म ि न ट ा व ध ि क े |
अशेष	अ श े ष |
अशेषदेशे	अ श े ष द े श े |
अशोभत	अ श ो भ त |
अश्लीलानि	अ श ् ल ी ल ा न ि |
अश्वत्थमृकोल्पन्ने	अ श ् व त ् थ म ृ क ो ल ् प न ् न े |
अश्वेभ्यः	अ श ् व े भ ् य ः |
अष्टक	अ ष ् ट क |
अष्टकालहोमाद्	अ ष ् ट क ा ल ह ो म ा द ् |
अष्टनवतिसहस्रोत्तरत्रिंशत्	अ ष ् ट न व त ि स ह स ् र ो त ् त र त ् र ि ं श त ् |
अष्टमनवमयोः	अ ष ् ट म न व म य ो ः |
अष्टवादनाद्	अ ष ् ट व ा द न ा द ् |
अष्टषष्टितमं	अ ष ् ट ष ष ् ट ि त म ं |
अष्टसप्तत्युत्तर	अ ष ् ट स प ् त त ् य ु त ् त र |
अष्टाकपालः	अ ष ् ट ा क प ा ल ः |
अष्टात्रिंशत्	अ ष ् ट ा त ् र ि ं श त ् |
अष्टादश	अ ष ् ट ा द श |
अष्टादशे	अ ष ् ट ा द श े |
अष्टोत्तर्	अ ष ् ट ो त ् त र ् |
अष्टौ	अ ष ् ट ौ |
असम	अ स म |
असमप्रशासनम्	अ स म प ् र श ा स न म ् |
असमराज्ये	अ स म र ा ज ् य े |
असमे	अ स म े |
असम्	अ स म ् |
असम्नागालैण्ड्सीम्नि	अ स म ् न ा ग ा ल ै ण ् ड ् स ी म ् न ि |
असिन्	अ स ि न ् |
असूचयत्	अ स ू च य त ् |
असौ	अ स ौ |
अस्ति	अ स ् त ि |
अस्पृश्चतायाश्च	अ स ् प ृ श ् च त ा य ा श ् च |
अस्मदीयो	अ स ् म द ी य ो |
अस्मन्	अ स ् म न ् |
अस्माकं	अ स ् म ा क ं |
अस्मात्	अ स ् म ा त ् |
अस्माभिः	अ स ् म ा भ ि ः |
अस्मासु	अ स ् म ा स ु |
अस्मिन्	अ स ् म ि न ् |
अस्मिन्नेव	अ स ् म ि न ् न े व |
अस्म्	अ स ् म ् |
अस्य	अ स ् य |
अस्यां	अ स ् य ा ं |
अस्याः	अ स ् य ा ः |
अस्योपवेशनस्य	अ स ् य ो प व े श न स ् य |
अस्वतन्त्रं	अ स ् व त न ् त ् र ं |
अस्वतन्त्राणि	अ स ् व त न ् त ् र ा ण ि |
अहं	अ ह ं |
अहः	अ ह ः |
अहमदाबादे	अ ह म द ा ब ा द े |
अहरहः	अ ह र ह ः |
अहसु	अ ह स ु |
अहस्सु	अ ह स ् स ु |
अहिंसां	अ ह ि ं स ा ं |
अहूयमानो	अ ह ू य म ा न ो |
अहोरात्रे	अ ह ो र ा त ् र े |
अह्नि	अ ह ् न ि |
अह्न्ः	अ ह ् न ् ः |
आ	आ |
आंगलौंगजनपदे	आ ं ग ल ौ ं ग ज न प द े |
आंतङ्कवादिनः	आ ं त ङ ् क व ा द ि न ः |
आई	आ ई |
आईएन्एस्	आ ई ए न ् ए स ् |
आकलितास्ति	आ क ल ि त ा स ् त ि |
आकल्प्यते	आ क ल ् प ् य त े |
आकाङ्क्षाणां	आ क ा ङ ् क ् ष ा ण ा ं |
आकारयति	आ क ा र य त ि |
आकारयत्	आ क ा र य त ् |
आकारितः	आ क ा र ि त ः |
आकारितम्	आ क ा र ि त म ् |
आकार्य	आ क ा र ् य |
आकाशवाण्याः	आ क ा श व ा ण ् य ा ः |
आक्रन्दनं	आ क ् र न ् द न ं |
आक्रमण	आ क ् र म ण |
आक्रमणं	आ क ् र म ण ं |
आक्रमणदायित्वम्	आ क ् र म ण द ा य ि त ् व म ् |
आक्रमणस्य	आ क ् र म ण स ् य |
आक्रमणानि	आ क ् र म ण ा न ि |
आक्रमणे	आ क ् र म ण े |
आक्रमणेषु	आ क ् र म ण े ष ु |
आक्षिपति	आ क ् ष ि प त ि |
आक्षिप्तः	आ क ् ष ि प ् त ः |
आख्या	आ ख ् य ा |
आगतम्	आ ग त म ् |
आगमनाय	आ ग म न ा य |
आगामिनि	आ ग ा म ि न ि |
आगामिमासस्य	आ ग ा म ि म ा स स ् य |
आगामिमासे	आ ग ा म ि म ा स े |
आगाम्येकमासपर्यन्तम्	आ ग ा म ् य े क म ा स प र ् य न ् त म ् |
आग्नेय	आ ग ् न े य |
आग्नेयः	आ ग ् न े य ः |
आग्नेयो	आ ग ् न े य ो |
आग्रयण	आ ग ् र य ण |
आघातरूपेण	आ घ ा त र ू प े ण |
आङ्	आ ङ ् |
आचक्ष्यते	आ च क ् ष ् य त े |
आचरणमेतस्य	आ च र ण म े त स ् य |
आचरणीयानि	आ च र ण ी य ा न ि |
आचरन्ति	आ च र न ् त ि |
आचरितानि	आ च र ि त ा न ि |
आचान्तेन	आ च ा न ् त े न |
आचार	आ च ा र |
आचारः	आ च ा र ः |
आचारसंहितायाः	आ च ा र स ं ह ि त ा य ा ः |
आचाराः	आ च ा र ा ः |
आचारात्	आ च ा र ा त ् |
आचारार्थेन	आ च ा र ा र ् थ े न |
आचारो	आ च ा र ो |
आच्छिन्न्म्	आ च ् छ ि न ् न ् म ् |
आच्छेत्ता	आ च ् छ े त ् त ा |
आच्छेदन	आ च ् छ े द न |
आज्यस्य	आ ज ् य स ् य |
आज्यहविषा	आ ज ् य ह व ि ष ा |
आड्वाणीं	आ ड ् व ा ण ी ं |
आतंकवादि	आ त ं क व ा द ि |
आतंकवादिनं	आ त ं क व ा द ि न ं |
आतंकवादिनः	आ त ं क व ा द ि न ः |
आतंकवादिनो	आ त ं क व ा द ि न ो |
आतंकवादिनौ	आ त ं क व ा द ि न ौ |
आतंकवादिभिः	आ त ं क व ा द ि भ ि ः |
आतंकवादी	आ त ं क व ा द ी |
आतंकवादीसंघटनस्य	आ त ं क व ा द ी स ं घ ट न स ् य |
आतङ्कवादिनां	आ त ङ ् क व ा द ि न ा ं |
आतङ्कवादिभिः	आ त ङ ् क व ा द ि भ ि ः |
आतङ्कवाद्याक्रमणेन	आ त ङ ् क व ा द ् य ा क ् र म ण े न |
आतङ्कसमर्थनार्थं	आ त ङ ् क स म र ् थ न ा र ् थ ं |
आततायिभिः	आ त त ा य ि भ ि ः |
आततिमयी	आ त त ि म य ी |
आततिमयीं	आ त त ि म य ी ं |
आतपशुष्काणि	आ त प श ु ष ् क ा ण ि |
आतिथेयं	आ त ि थ े य ं |
आतिथ्यादीनि	आ त ि थ ् य ा द ी न ि |
आत्म	आ त ् म |
आत्मगुणः	आ त ् म ग ु ण ः |
आत्मघातमालक्ष्य	आ त ् म घ ा त म ा ल क ् ष ् य |
आत्मघात्याक्रमणकारिभिः	आ त ् म घ ा त ् य ा क ् र म ण क ा र ि भ ि ः |
आत्मघात्याक्रमणम्	आ त ् म घ ा त ् य ा क ् र म ण म ् |
आत्मज्ञानञ्च	आ त ् म ज ् ञ ा न ञ ् च |
आत्मज्ञानस्य	आ त ् म ज ् ञ ा न स ् य |
आत्मनः	आ त ् म न ः |
आत्मप्रतिपादनेनैव	आ त ् म प ् र त ि प ा द न े न ै व |
आदत्ताः	आ द त ् त ा ः |
आदमी	आ द म ी |
आदरणीयत्वात्	आ द र ण ी य त ् व ा त ् |
आदरोपि	आ द र ो प ि |
आदर्श	आ द र ् श |
आदशी	आ द श ी |
आदित्याज्जायते	आ द ि त ् य ा ज ् ज ा य त े |
आदिशत्	आ द ि श त ् |
आदिष्टमस्ति	आ द ि ष ् ट म स ् त ि |
आदिष्टम्	आ द ि ष ् ट म ् |
आदृत्य	आ द ृ त ् य |
आदेशः	आ द े श ः |
आदौ	आ द ौ |
आद्मी	आ द ् म ी |
आद्यं	आ द ् य ं |
आद्यकाण्ड	आ द ् य क ा ण ् ड |
आद्यम्	आ द ् य म ् |
आद्यस्य	आ द ् य स ् य |
आद्या	आ द ् य ा |
आद्यां	आ द ् य ा ं |
आद्येन	आ द ् य े न |
आधातुं	आ ध ा त ु ं |
आधार	आ ध ा र |
आधारशिविराद्	आ ध ा र श ि व ि र ा द ् |
आधिकारिभिः	आ ध ि क ा र ि भ ि ः |
आधु	आ ध ु |
आध्यक्षयुतया	आ ध ् य क ् ष य ु त य ा |
आध्यक्षयुतेन	आ ध ् य क ् ष य ु त े न |
आध्यक्ष्यं	आ ध ् य क ् ष ् य ं |
आनन्तर्यं	आ न न ् त र ् य ं |
आनन्दीबेनपटेलः	आ न न ् द ी ब े न प ट े ल ः |
आनयनम्	आ न य न म ् |
आनुकूल्यम्	आ न ु क ू ल ् य म ् |
आनैकेभ्यो	आ न ै क े भ ् य ो |
आन्तःसेवासार्वजनिक	आ न ् त ः स े व ा स ा र ् व ज न ि क |
आन्ध्रप्रदेश	आ न ् ध ् र प ् र द े श |
आन्ध्रप्रदेशराज्यपालेन	आ न ् ध ् र प ् र द े श र ा ज ् य प ा ल े न |
आन्ध्रप्रदेशस्य	आ न ् ध ् र प ् र द े श स ् य |
आन्ध्रप्रदेशात्	आ न ् ध ् र प ् र द े श ा त ् |
आन्ध्रप्रदेशारुणाचलप्रदेशविधानसभानां	आ न ् ध ् र प ् र द े श ा र ु ण ा च ल प ् र द े श व ि ध ा न स भ ा न ा ं |
आन्ध्रप्रदेशे	आ न ् ध ् र प ् र द े श े |
आन्ध्रप्रेदश	आ न ् ध ् र प ् र े द श |
आन्ध्रप्रेदशतेलंगानाराज्ययोः	आ न ् ध ् र प ् र े द श त े ल ं ग ा न ा र ा ज ् य य ो ः |
आपञ्चम्याः	आ प ञ ् च म ् य ा ः |
आपणानुसारि	आ प ण ा न ु स ा र ि |
आपत्	आ प त ् |
आपत्योजनानां	आ प त ् य ो ज न ा न ा ं |
आपस्तंब	आ प स ् त ं ब |
आपस्तंबः	आ प स ् त ं ब ः |
आपस्तंबधर्मसूत्रस्य	आ प स ् त ं ब ध र ् म स ू त ् र स ् य |
आपस्तंबप्रणीतं	आ प स ् त ं ब प ् र ण ी त ं |
आपस्तंबमतेन	आ प स ् त ं ब म त े न |
आपस्तंबसूत्रं	आ प स ् त ं ब स ू त ् र ं |
आपस्तंबसूत्रमेव	आ प स ् त ं ब स ू त ् र म े व |
आपस्तंबसूत्राणां	आ प स ् त ं ब स ू त ् र ा ण ा ं |
आपस्तंबेन	आ प स ् त ं ब े न |
आपस्तंबैः	आ प स ् त ं ब ै ः |
आपात	आ प ा त |
आपूर्तिं	आ प ू र ् त ि ं |
आपूर्तिः	आ प ू र ् त ि ः |
आपूर्तिसंवर्धनार्थं	आ प ू र ् त ि स ं व र ् ध न ा र ् थ ं |
आपूर्यमाणपक्षे	आ प ू र ् य म ा ण प क ् ष े |
आप्	आ प ् |
आप्दलायप्रदेयम्	आ प ् द ल ा य प ् र द े य म ् |
आभाति	आ भ ा त ि |
आभिस्वीकृतः	आ भ ि स ् व ी क ृ त ः |
आम	आ म |
आमआदमीपार्टीति	आ म आ द म ी प ा र ् ट ी त ि |
आमन्त्रयति	आ म न ् त ् र य त ि |
आमन्त्रितवान्	आ म न ् त ् र ि त व ा न ् |
आमान्यते	आ म ा न ् य त े |
आम्	आ म ् |
आम्आद्मीपार्टीतिदलस्य	आ म ् आ द ् म ी प ा र ् ट ी त ि द ल स ् य |
आम्आद्मीपार्टीतिदलाय	आ म ् आ द ् म ी प ा र ् ट ी त ि द ल ा य |
आम्रवृक्षे	आ म ् र व ृ क ् ष े |
आय	आ य |
आयकर	आ य क र |
आयजातं	आ य ज ा त ं |
आयव्यय	आ य व ् य य |
आयव्ययपत्रकसत्रारम्भात्	आ य व ् य य प त ् र क स त ् र ा र म ् भ ा त ् |
आयव्ययपत्रकीय	आ य व ् य य प त ् र क ी य |
आयुध	आ य ु ध |
आयुधानां	आ य ु ध ा न ा ं |
आयुर्विज्ञान	आ य ु र ् व ि ज ् ञ ा न |
आयोगस्य	आ य ो ग स ् य |
आयोजनं	आ य ो ज न ं |
आयोजयति	आ य ो ज य त ि |
आयोजयिष्यते	आ य ो ज य ि ष ् य त े |
आयोजयिष्यन्ते	आ य ो ज य ि ष ् य न ् त े |
आयोजयिष्यमाणेभ्यः	आ य ो ज य ि ष ् य म ा ण े भ ् य ः |
आयोज्यते	आ य ो ज ् य त े |
आयोज्यमानसमारोहाणां	आ य ो ज ् य म ा न स म ा र ो ह ा ण ा ं |
आयोज्यमानो	आ य ो ज ् य म ा न ो |
आरंभे	आ र ं भ े |
आरक्षणां	आ र क ् ष ण ा ं |
आरक्षि	आ र क ् ष ि |
आरप्स्यते	आ र प ् स ् य त े |
आरप्स्यन्ते	आ र प ् स ् य न ् त े |
आरब्धम्	आ र ब ् ध म ् |
आरब्धा	आ र ब ् ध ा |
आरब्धारः	आ र ब ् ध ा र ः |
आरभत	आ र भ त |
आरभते	आ र भ त े |
आरुह्य	आ र ु ह ् य |
आरोग्यादिकं	आ र ो ग ् य ा द ि क ं |
आरोपाणां	आ र ो प ा ण ा ं |
आरोपिणां	आ र ो प ि ण ा ं |
आर्	आ र ् |
आर्एम्लोढा	आ र ् ए म ् ल ो ढ ा |
आर्एस्पुरा	आ र ् ए स ् प ु र ा |
आर्एस्पुराक्षेत्रे	आ र ् ए स ् प ु र ा क ् ष े त ् र े |
आर्थिक	आ र ् थ ि क |
आर्थिकसर्वेक्षणानुसारि	आ र ् थ ि क स र ् व े क ् ष ण ा न ु स ा र ि |
आर्थिक्कार्यकारिणी	आ र ् थ ि क ् क ा र ् य क ा र ि ण ी |
आर्मीहोस्पिटलइति	आ र ् म ी ह ो स ् प ि ट ल इ त ि |
आर्षेय	आ र ् ष े य |
आलक्ष्य	आ ल क ् ष ् य |
आलस्यादिना	आ ल स ् य ा द ि न ा |
आलुकानां	आ ल ु क ा न ा ं |
आलोचितव	आ ल ो च ि त व |
आलोचितवत्	आ ल ो च ि त व त ् |
आवश्यकम्	आ व श ् य क म ् |
आवश्यक्तां	आ व श ् य क ् त ा ं |
आवहता	आ व ह त ा |
आवहन्ति	आ व ह न ् त ि |
आवासऋणविषयिणी	आ व ा स ऋ ण व ि ष य ि ण ी |
आविर्भः	आ व ि र ् भ ः |
आविर्भवन्ती	आ व ि र ् भ व न ् त ी |
आविर्भावः	आ व ि र ् भ ा व ः |
आविर्भूतः	आ व ि र ् भ ू त ः |
आविर्भूतमिति	आ व ि र ् भ ू त म ि त ि |
आविर्भूतमित्यर्थः	आ व ि र ् भ ू त म ि त ् य र ् थ ः |
आविर्भूतानिवा	आ व ि र ् भ ू त ा न ि व ा |
आवे	आ व े |
आशा	आ श ा |
आशां	आ श ा ं |
आशान्वितो	आ श ा न ् व ि त ो |
आशान्वितौ	आ श ा न ् व ि त ौ |
आशास्तं	आ श ा स ् त ं |
आश्रमस्य	आ श ् र म स ् य |
आश्रय	आ श ् र य |
आश्रितो	आ श ् र ि त ो |
आश्वलायन	आ श ् व ल ा य न |
आश्वासयत्	आ श ् व ा स य त ् |
आसन	आ स न |
आसनानि	आ स न ा न ि |
आसनाय	आ स न ा य |
आसन्	आ स न ् |
आसन्न	आ स न ् न |
आसियानसम्मेलने	आ स ि य ा न स म ् म े ल न े |
आसीत्	आ स ी त ् |
आस्ति	आ स ् त ि |
आहतछात्राणां	आ ह त छ ा त ् र ा ण ा ं |
आहताः	आ ह त ा ः |
आहत्य	आ ह त ् य |
आहुतय	आ ह ु त य |
आहुतयः	आ ह ु त य ः |
आहुती	आ ह ु त ी |
आह्वानं	आ ह ् व ा न ं |
इंछियन्नगरे	इ ं छ ि य न ् न ग र े |
इज़रायल	इ ज ़ र ा य ल |
इज़रायलदेशेन	इ ज ़ र ा य ल द े श े न |
इज़रायलप्रधान	इ ज ़ र ा य ल प ् र ध ा न |
इज़रायलयात्रानिरतो	इ ज ़ र ा य ल य ा त ् र ा न ि र त ो |
इण्डियन्प्रीमियर्लीग्क्रिकेट्स्पर्धा	इ ण ् ड ि य न ् प ् र ी म ि य र ् ल ी ग ् क ् र ि क े ट ् स ् प र ् ध ा |
इण्डीज़्क्रिकेट्वृन्दं	इ ण ् ड ी ज ़ ् क ् र ि क े ट ् व ृ न ् द ं |
इतः	इ त ः |
इतणा	इ त ण ा |
इतणाण्यपिकल्पसूत्राणि	इ त ण ा ण ् य प ि क ल ् प स ू त ् र ा ण ि |
इतराः	इ त र ा ः |
इति	इ त ि |
इतिजनता	इ त ि ज न त ा |
इतिपवित्रव्रत	इ त ि प व ि त ् र व ् र त |
इतीयं	इ त ी य ं |
इते	इ त े |
इत्	इ त ् |
इत्थं	इ त ् थ ं |
इत्यतः	इ त ् य त ः |
इत्यत्र	इ त ् य त ् र |
इत्यत्राति	इ त ् य त ् र ा त ि |
इत्यत्रैव	इ त ् य त ् र ै व |
इत्यदि	इ त ् य द ि |
इत्यपि	इ त ् य प ि |
इत्यभिप्रायः	इ त ् य भ ि प ् र ा य ः |
इत्यर्थः	इ त ् य र ् थ ः |
इत्यववति	इ त ् य व व त ि |
इत्यस्ति	इ त ् य स ् त ि |
इत्यस्मिन्	इ त ् य स ् म ि न ् |
इत्यस्य	इ त ् य स ् य |
इत्याकल्प्यते	इ त ् य ा क ल ् प ् य त े |
इत्यादि	इ त ् य ा द ि |
इत्यारभ्य	इ त ् य ा र भ ् य |
इत्याशंक्यते	इ त ् य ा श ं क ् य त े |
इत्युक्तत्वात्	इ त ् य ु क ् त त ् व ा त ् |
इत्युक्तप्रात्	इ त ् य ु क ् त प ् र ा त ् |
इत्युक्ते	इ त ् य ु क ् त े |
इत्युक्त्	इ त ् य ु क ् त ् |
इत्युच्यते	इ त ् य ु च ् य त े |
इत्युदीर्य	इ त ् य ु द ी र ् य |
इत्येकस्य	इ त ् य े क स ् य |
इत्येते	इ त ् य े त े |
इदं	इ द ं |
इदम्	इ द म ् |
इदानं	इ द ा न ं |
इदानीं	इ द ा न ी ं |
इदानीन्तने	इ द ा न ी न ् त न े |
इन्	इ न ् |
इन्दियञ्च	इ न ् द ि य ञ ् च |
इन्द्रः	इ न ् द ् र ः |
इन्द्रस्य	इ न ् द ् र स ् य |
इन्द्रियाणि	इ न ् द ् र ि य ा ण ि |
इन्द्रियेण	इ न ् द ् र ि य े ण |
इमे	इ म े |
इयं	इ य ं |
इराकदेशे	इ र ा क द े श े |
इराकधिकारिभि	इ र ा क ध ि क ा र ि भ ि |
इराकप्रशासनेन	इ र ा क प ् र श ा स न े न |
इराकयात्रार्थं	इ र ा क य ा त ् र ा र ् थ ं |
इराकस्य	इ र ा क स ् य |
इराकात्	इ र ा क ा त ् |
इराके	इ र ा क े |
इव	इ व |
इस्रयलीयविमानैः	इ स ् र य ल ी य व ि म ा न ै ः |
इस्लामाबादस्य	इ स ् ल ा म ा ब ा द स ् य |
इस्लामिक	इ स ् ल ा म ि क |
इस्लामीयराज्योग्रवादिनः	इ स ् ल ा म ी य र ा ज ् य ो ग ् र व ा द ि न ः |
इह	इ ह |
ईएस्एल्	ई ए स ् ए ल ् |
ईदपर्व	ई द प र ् व |
ईद्उल्फ़ितर	ई द ् उ ल ् फ ़ ि त र |
ईद्उल्फ़ित्रपर्व्	ई द ् उ ल ् फ ़ ि त ् र प र ् व ् |
ईरानी	ई र ा न ी |
ईशानबलिः	ई श ा न ब ल ि ः |
ईश्वराधीनं	ई श ् व र ा ध ी न ं |
उ	उ |
उक्	उ क ् |
उक्तं	उ क ् त ं |
उक्तः	उ क ् त ः |
उक्तत्वात्	उ क ् त त ् व ा त ् |
उक्तमस्ति	उ क ् त म स ् त ि |
उक्तम्	उ क ् त म ् |
उक्तवान्	उ क ् त व ा न ् |
उक्ता	उ क ् त ा |
उक्ताः	उ क ् त ा ः |
उक्तानि	उ क ् त ा न ि |
उक्ते	उ क ् त े |
उक्तो	उ क ् त ो |
उक्तोपि	उ क ् त ो प ि |
उक्तौ	उ क ् त ौ |
उक्थ्यः	उ क ् थ ् य ः |
उग्रवादतः	उ ग ् र व ा द त ः |
उच्च	उ च ् च |
उच्चतम	उ च ् च त म |
उच्चतमन्यायालयेन	उ च ् च त म न ् य ा य ा ल य े न |
उच्चतरा	उ च ् च त र ा |
उच्चतरार्थिक	उ च ् च त र ा र ् थ ि क |
उच्चतर्	उ च ् च त र ् |
उच्चसर्वोच्च	उ च ् च स र ् व ो च ् च |
उच्चस्तरीयोपवेशनं	उ च ् च स ् त र ी य ो प व े श न ं |
उच्यते	उ च ् य त े |
उच्यतेइति	उ च ् य त े इ त ि |
उच्यन्ते	उ च ् य न ् त े |
उच्यमानत्वात्	उ च ् य म ा न त ् व ा त ् |
उच्येत	उ च ् य े त |
उत्तम	उ त ् त म |
उत्तमा	उ त ् त म ा |
उत्तमावृष्टिर्भवति	उ त ् त म ा व ृ ष ् ट ि र ् भ व त ि |
उत्तरदायिनः	उ त ् त र द ा य ि न ः |
उत्तरन्	उ त ् त र न ् |
उत्तरप्रदेशप्रशासनं	उ त ् त र प ् र द े श प ् र श ा स न ं |
उत्तरप्रदेशप्रशासनाय	उ त ् त र प ् र द े श प ् र श ा स न ा य |
उत्तरप्रदेशशासनं	उ त ् त र प ् र द े श श ा स न ं |
उत्तरप्रदेशस्य	उ त ् त र प ् र द े श स ् य |
उत्तरप्रदेशे	उ त ् त र प ् र द े श े |
उत्तरमीमांसायां	उ त ् त र म ी म ा ं स ा य ा ं |
उत्तरशालायां	उ त ् त र श ा ल ा य ा ं |
उत्पतनात्	उ त ् प त न ा त ् |
उत्पतनार्थम्	उ त ् प त न ा र ् थ म ् |
उत्पन्नं	उ त ् प न ् न ं |
उत्पन्नः	उ त ् प न ् न ः |
उत्पवनादेः	उ त ् प व न ा द े ः |
उत्पाद	उ त ् प ा द |
उत्सर्जनानि	उ त ् स र ् ज न ा न ि |
उत्सवेषु	उ त ् स व े ष ु |
उदगदे	उ द ग द े |
उदगयन	उ द ग य न |
उदगयनस्य	उ द ग य न स ् य |
उदगयनादि	उ द ग य न ा द ि |
उदगयनादीनां	उ द ग य न ा द ी न ा ं |
उदगयने	उ द ग य न े |
उदगयादीनि	उ द ग य ा द ी न ि |
उदगयाद्	उ द ग य ा द ् |
उदग्रयान	उ द ग ् र य ा न |
उदग्रयानानि	उ द ग ् र य ा न ा न ि |
उदग्वा	उ द ग ् व ा |
उदघोषयत्	उ द घ ो ष य त ् |
उदरवेदनां	उ द र व े द न ा ं |
उदितानुदितेन	उ द ि त ा न ु द ि त े न |
उदीचीन	उ द ी च ी न |
उदीरितानि	उ द ी र ि त ा न ि |
उदृग्र	उ द ृ ग ् र |
उद्गयने	उ द ् ग य न े |
उद्घाटयितुं	उ द ् घ ा ट य ि त ु ं |
उद्घोषयिष्यन्ते	उ द ् घ ो ष य ि ष ् य न ् त े |
उद्घोषितमस्ति	उ द ् घ ो ष ि त म स ् त ि |
उद्घोषितम्	उ द ् घ ो ष ि त म ् |
उद्देशत्	उ द ् द े श त ् |
उद्देश्यमस्ति	उ द ् द े श ् य म स ् त ि |
उद्धरणाय	उ द ् ध र ण ा य |
उद्भवति	उ द ् भ व त ि |
उद्यतं	उ द ् य त ं |
उन्नत	उ न ् न त |
उन्मूलयितुं	उ न ् म ू ल य ि त ु ं |
उपक्रम	उ प क ् र म |
उपक्रमः	उ प क ् र म ः |
उपगतेभ्योः	उ प ग त े भ ् य ो ः |
उपदशानि	उ प द श ा न ि |
उपदिदेश	उ प द ि द े श |
उपदिदेष	उ प द ि द े ष |
उपदिष्टः	उ प द ि ष ् ट ः |
उपद्रवग्रस्ते	उ प द ् र व ग ् र स ् त े |
उपद्रवजननार्थं	उ प द ् र व ज न न ा र ् थ ं |
उपनयन	उ प न य न |
उपनिदृश्यते	उ प न ि द ृ श ् य त े |
उपनिबध्य	उ प न ि ब ध ् य |
उपनिर्वाचनेभ्यः	उ प न ि र ् व ा च न े भ ् य ः |
उपन्यस्तम्	उ प न ् य स ् त म ् |
उपपातक	उ प प ा त क |
उपपादयितुं	उ प प ा द य ि त ु ं |
उपराज्यपालं	उ प र ा ज ् य प ा ल ं |
उपराष्ट्रपतिः	उ प र ा ष ् ट ् र प त ि ः |
उपरि	उ प र ि |
उपलम्भयितुं	उ प ल म ् भ य ि त ु ं |
उपवासश्च	उ प व ा स श ् च |
उपवेशनमेकं	उ प व े श न म े क ं |
उपवेशनानन्तरं	उ प व े श न ा न न ् त र ं |
उपवेशनार्थं	उ प व े श न ा र ् थ ं |
उपसर्गः	उ प स र ् ग ः |
उपस्थातुं	उ प स ् थ ा त ु ं |
उपस्थापयामिय	उ प स ् थ ा प य ा म ि य |
उपस्थापितवती	उ प स ् थ ा प ि त व त ी |
उपस्थितीः	उ प स ् थ ि त ी ः |
उपहरिष्यति	उ प ह र ि ष ् य त ि |
उपांशु	उ प ा ं श ु |
उपांशु्यागस्य	उ प ा ं श ु ् य ा ग स ् य |
उपानुवाक्य	उ प ा न ु व ा क ् य |
उपान्त्यचक्रं	उ प ा न ् त ् य च क ् र ं |
उपान्त्यचक्रे	उ प ा न ् त ् य च क ् र े |
उपायनीकर्तुं	उ प ा य न ी क र ् त ु ं |
उपायनीकृताः	उ प ा य न ी क ृ त ा ः |
उपालम्भयिष्यते	उ प ा ल म ् भ य ि ष ् य त े |
उपास्थापयत्	उ प ा स ् थ ा प य त ् |
उभय	उ भ य |
उभयत्रापि	उ भ य त ् र ा प ि |
उभयपाक्षिकसम्भाषणानि	उ भ य प ा क ् ष ि क स म ् भ ा ष ण ा न ि |
उभयोः	उ भ य ो ः |
उभाभ्याम्	उ भ ा भ ् य ा म ् |
उभौ	उ भ ौ |
उयमत्रेवत्	उ य म त ् र े व त ् |
उर्वरकोपलब्धिञ्च	उ र ् व र क ो प ल ब ् ध ि ञ ् च |
उल्लंघनं	उ ल ् ल ं घ न ं |
उल्लंघनमस्ति	उ ल ् ल ं घ न म स ् त ि |
उल्लङ्घन	उ ल ् ल ङ ् घ न |
उल्लङ्घनं	उ ल ् ल ङ ् घ न ं |
उल्लङ्घ्य	उ ल ् ल ङ ् घ ् य |
उवटमहीधरादयः	उ व ट म ह ी ध र ा द य ः |
उषणै	उ ष ण ै |
उष्णं	उ ष ् ण ं |
उष्णः	उ ष ् ण ः |
उष्णापेक्षया	उ ष ् ण ा प े क ् ष य ा |
उहु	उ ह ु |
ऊध्वं	ऊ ध ् व ं |
ऊन	ऊ न |
ऊर्ध्वं	ऊ र ् ध ् व ं |
ऋग्वेदस्य	ऋ ग ् व े द स ् य |
ऋडत्रयेण	ऋ ड त ् र य े ण |
ऋणवाजायते	ऋ ण व ा ज ा य त े |
ऋत	ऋ त |
ऋतुविभागीयनिदेशकेन	ऋ त ु व ि भ ा ग ी य न ि द े श क े न |
ऋतुविभागेन	ऋ त ु व ि भ ा ग े न |
ऋषिभ्यो	ऋ ष ि भ ् य ो |
एक	ए क |
एकं	ए क ं |
एकः	ए क ः |
एकतो	ए क त ो |
एकत्	ए क त ् |
एकत्र	ए क त ् र |
एकदेशविवक्षया	ए क द े श व ि व क ् ष य ा |
एकम्	ए क म ् |
एकयो	ए क य ो |
एकलवर्गस्य	ए क ल व र ् ग स ् य |
एकस्मिन्	ए क स ् म ि न ् |
एकस्य	ए क स ् य |
एकस्यां	ए क स ् य ा ं |
एका	ए क ा |
एकाकिना	ए क ा क ि न ा |
एकात्	ए क ा त ् |
एकादश	ए क ा द श |
एकादशतो	ए क ा द श त ो |
एकादशमिता	ए क ा द श म ि त ा |
एकादशराज्यानां	ए क ा द श र ा ज ् य ा न ा ं |
एकान्तिकत्वं	ए क ा न ् त ि क त ् व ं |
एकाम्	ए क ा म ् |
एकाशाखाध्ययते	ए क ा श ा ख ा ध ् य य त े |
एकाशीतिसहस्रोत्तरपञ्च	ए क ा श ी त ि स ह स ् र ो त ् त र प ञ ् च |
एकीकृत्	ए क ी क ृ त ् |
एकीभूतः	ए क ी भ ू त ः |
एकेन	ए क े न |
एकैव	ए क ै व |
एको	ए क ो |
एकोन	ए क ो न |
एकोनेन	ए क ो न े न |
एतं	ए त ं |
एतच्च	ए त च ् च |
एतज्जातं	ए त ज ् ज ा त ं |
एतत्	ए त त ् |
एतत्जा	ए त त ् ज ा |
एतदतिरिच्य	ए त द त ि र ि च ् य |
एतद्	ए त द ् |
एतद्वयं	ए त द ् व य ं |
एतन्	ए त न ् |
एतस्य	ए त स ् य |
एताः	ए त ा ः |
एताग्	ए त ा ग ् |
एतादृश्यां	ए त ा द ृ श ् य ा ं |
एतानि	ए त ा न ि |
एतान्	ए त ा न ् |
एताभ्यां	ए त ा भ ् य ा ं |
एतावताविशिष्टमित्येव्	ए त ा व त ा व ि श ि ष ् ट म ि त ् य े व ् |
एतावत्तुशक्यं	ए त ा व त ् त ु श क ् य ं |
एते	ए त े |
एतेषां	ए त े ष ा ं |
एतेषु	ए त े ष ु |
एतैः	ए त ै ः |
एतौ	ए त ौ |
एत्	ए त ् |
एदत्	ए द त ् |
एधिष्यति	ए ध ि ष ् य त ि |
एन्	ए न ् |
एन्सैक्लोपीडिया	ए न ् स ै क ् ल ो प ी ड ि य ा |
एम्	ए म ् |
एम्सइत्यस्मिन्	ए म ् स इ त ् य स ् म ि न ् |
एल्	ए ल ् |
एव	ए व |
एवं	ए व ं |
एवअग्निः	ए व अ ग ् न ि ः |
एवमुक्तं	ए व म ु क ् त ं |
एव्	ए व ् |
एशियाक्रीडा	ए श ि य ा क ् र ी ड ा |
एष	ए ष |
एषः	ए ष ः |
एषनिर्णयः	ए ष न ि र ् ण य ः |
एषा	ए ष ा |
एषो	ए ष ो |
एस्	ए स ् |
ऐक्याखण्डतयोः	ऐ क ् य ा ख ण ् ड त य ो ः |
ऐक्षत	ऐ क ् ष त |
ऐतिहातिकसांस्कृतिकमूल्येषु	ऐ त ि ह ा त ि क स ा ं स ् क ृ त ि क म ू ल ् य े ष ु |
ऐतिहासिकरक्तदुर्ग	ऐ त ि ह ा स ि क र क ् त द ु र ् ग |
ऐन्द्	ऐ न ् द ् |
ऐन्द्रं	ऐ न ् द ् र ं |
ऐन्द्रस्यदध्यः	ऐ न ् द ् र स ् य द ध ् य ः |
ऐन्द्राग्नपशु	ऐ न ् द ् र ा ग ् न प श ु |
ऐम	ऐ म |
ऐवं	ऐ व ं |
ऐषमः	ऐ ष म ः |
ओंकारसिंहः	ओ ं क ा र स ि ं ह ः |
ओडिशा	ओ ड ि श ा |
ओडिशापश्चिम	ओ ड ि श ा प श ् च ि म |
ओडिशायां	ओ ड ि श ा य ा ं |
ओडिशाराज्ये	ओ ड ि श ा र ा ज ् य े |
ओडिशासिक्किम्	ओ ड ि श ा स ि क ् क ि म ् |
ओनलाइनइति	ओ न ल ा इ न इ त ि |
ओमन	ओ म न |
ओस्ट्रेलिया	ओ स ् ट ् र े ल ि य ा |
औ	औ |
औपासन	औ प ा स न |
औष्ण्यं	औ ष ् ण ् य ं |
कः	क ः |
कक्षायाः	क क ् ष ा य ा ः |
कक्ष्यायां	क क ् ष ् य ा य ा ं |
कटककेन्द्रपाराजगतसिंहपुर्पुरीजनपदानाम्	क ट क क े न ् द ् र प ा र ा ज ग त स ि ं ह प ु र ् प ु र ी ज न प द ा न ा म ् |
कटुटीकापात्रतां	क ट ु ट ी क ा प ा त ् र त ा ं |
कट्वालोचितः	क ट ् व ा ल ो च ि त ः |
कट्वालोचितम्	क ट ् व ा ल ो च ि त म ् |
कट्वालोचिताः	क ट ् व ा ल ो च ि त ा ः |
कण्ठः	क ण ् ठ ः |
कण्डस्य	क ण ् ड स ् य |
कतिपय	क त ि प य |
कतिपयदिवस	क त ि प य द ि व स |
कतिपयहिंस्र	क त ि प य ह ि ं स ् र |
कतिपयाः	क त ि प य ा ः |
कत्चप	क त ् च प |
कत्वम्	क त ् व म ् |
कथं	क थ ं |
कथंकारमपि	क थ ं क ा र म प ि |
कथङ्कारमपि	क थ ङ ् क ा र म प ि |
कथमपि	क थ म प ि |
कथमभवत्	क थ म भ व त ् |
कथमववत्	क थ म व व त ् |
कथमिति	क थ म ि त ि |
कथमित्युक्ते	क थ म ि त ् य ु क ् त े |
कथमे	क थ म े |
कथमेतत्	क थ म े त त ् |
कथय	क थ य |
कथयति	क थ य त ि |
कथयिष्यामि	क थ य ि ष ् य ा म ि |
कथितं	क थ ि त ं |
कथितम्	क थ ि त म ् |
कथितोल्लङ्घनप्रकरणे	क थ ि त ो ल ् ल ङ ् घ न प ् र क र ण े |
कथ्यते	क थ ् य त े |
कदाचित्	क द ा च ि त ् |
कपिलोपि	क प ि ल ो प ि |
कमल	क म ल |
कमलाबेनीवाल्महाभागायाः	क म ल ा ब े न ी व ा ल ् म ह ा भ ा ग ा य ा ः |
कमलाबेनीवाल्महाभागायै	क म ल ा ब े न ी व ा ल ् म ह ा भ ा ग ा य ै |
कमोर्ताइति	क म ो र ् त ा इ त ि |
कर	क र |
करजई	क र ज ई |
करणादेः	क र ण ा द े ः |
करणीयः	क र ण ी य ः |
करणीयमेव	क र ण ी य म े व |
करमितिषु	क र म ि त ि ष ु |
करविरहिता	क र व ि र ह ि त ा |
करसम्बद्धं	क र स म ् ब द ् ध ं |
कराचीनगरस्ये	क र ा च ी न ग र स ् य े |
कराचीनगरे	क र ा च ी न ग र े |
कराचीविमान	क र ा च ी व ि म ा न |
कराधानं	क र ा ध ा न ं |
कराधानस्य	क र ा ध ा न स ् य |
करापवञ्चनपुरस्सरं	क र ा प व ञ ् च न प ु र स ् स र ं |
करो	क र ो |
करोति	क र ो त ि |
करोत्	क र ो त ् |
कर्तव्यं	क र ् त व ् य ं |
कर्तव्यः	क र ् त व ् य ः |
कर्तव्यत्वेन	क र ् त व ् य त ् व े न |
कर्तव्यमिति	क र ् त व ् य म ि त ि |
कर्तव्यमित्यत्र	क र ् त व ् य म ि त ् य त ् र |
कर्तव्यमेव	क र ् त व ् य म े व |
कर्तव्यम्	क र ् त व ् य म ् |
कर्तव्यानि	क र ् त व ् य ा न ि |
कर्तुं	क र ् त ु ं |
कर्तुम्	क र ् त ु म ् |
कर्नलमुनीन्दनाथनारायय्	क र ् न ल म ु न ी न ् द न ा थ न ा र ा य य ् |
कर्बी	क र ् ब ी |
कर्म	क र ् म |
कर्मकरैः	क र ् म क र ै ः |
कर्मकाण्डे	क र ् म क ा ण ् ड े |
कर्मजन्यः	क र ् म ज न ् य ः |
कर्मणः	क र ् म ण ः |
कर्मणा	क र ् म ण ा |
कर्मणां	क र ् म ण ा ं |
कर्मणि	क र ् म ण ि |
कर्मणोन्यत्र	क र ् म ण ो न ् य त ् र |
कर्मसु	क र ् म स ु |
कर्माणं	क र ् म ा ण ं |
कर्माणि	क र ् म ा ण ि |
कर्माणिअवगतानिवा	क र ् म ा ण ि अ व ग त ा न ि व ा |
कर्माणिउक्तानि	क र ् म ा ण ि उ क ् त ा न ि |
कर्माण्येव	क र ् म ा ण ् य े व |
कर्मानुष्ठानन्तरं	क र ् म ा न ु ष ् ठ ा न न ् त र ं |
कर्मापि	क र ् म ा प ि |
कर्मिकान्	क र ् म ि क ा न ् |
कलहानन्तरं	क ल ह ा न न ् त र ं |
कल्पते	क ल ् प त े |
कल्पसूत्रं	क ल ् प स ू त ् र ं |
कल्पसूत्रमिति	क ल ् प स ू त ् र म ि त ि |
कल्याणे	क ल ् य ा ण े |
कवयो	क व य ो |
कश्मीर	क श ् म ी र |
कश्मीरराज्ये	क श ् म ी र र ा ज ् य े |
कश्मीरविषये	क श ् म ी र व ि ष य े |
कश्मीरस्य	क श ् म ी र स ् य |
कश्मीरीय	क श ् म ी र ी य |
कश्मीरे	क श ् म ी र े |
कश्मीरोपत्यकायां	क श ् म ी र ो प त ् य क ा य ा ं |
कश्मीर्	क श ् म ी र ् |
कष्टं	क ष ् ट ं |
कस्मात्	क स ् म ा त ् |
कस्माश्चिदपि	क स ् म ा श ् च ि द प ि |
कस्य	क स ् य |
कस्याश्चन	क स ् य ा श ् च न |
कांस्यानि	क ा ं स ् य ा न ि |
काजीरंगा	क ा ज ी र ं ग ा |
काठ्माण्डु	क ा ठ ् म ा ण ् ड ु |
काठ्माण्डुनगरे	क ा ठ ् म ा ण ् ड ु न ग र े |
काण्डं	क ा ण ् ड ं |
काण्डानाम्	क ा ण ् ड ा न ा म ् |
काण्डानि	क ा ण ् ड ा न ि |
काण्डे	क ा ण ् ड े |
काण्डोक्तानामेव	क ा ण ् ड ो क ् त ा न ा म े व |
कातरत्वेन	क ा त र त ् व े न |
कातरैः	क ा त र ै ः |
कानि	क ा न ि |
काने	क ा न े |
काबुलनगरीये	क ा ब ु ल न ग र ी य े |
कामादीन्	क ा म ा द ी न ् |
काम्येष्टु	क ा म ् य े ष ् ट ु |
कारणं	क ा र ण ं |
कारणमपि	क ा र ण म प ि |
कारणात्	क ा र ण ा त ् |
कारावासं	क ा र ा व ा स ं |
कारावासेन	क ा र ा व ा स े न |
कारिणी	क ा र ि ण ी |
कारुणिकः	क ा र ु ण ि क ः |
कार्प्यं	क ा र ् प ् य ं |
कार्यं	क ा र ् य ं |
कार्यकर्ता	क ा र ् य क र ् त ा |
कार्यकर्तृभिः	क ा र ् य क र ् त ृ भ ि ः |
कार्यकालः	क ा र ् य क ा ल ः |
कार्यक्रमस्य	क ा र ् य क ् र म स ् य |
कार्यक्रमाः	क ा र ् य क ् र म ा ः |
कार्यक्रमाणां	क ा र ् य क ् र म ा ण ा ं |
कार्यक्रमे	क ा र ् य क ् र म े |
कार्यक्रमेषु	क ा र ् य क ् र म े ष ु |
कार्यचरणार्थम्	क ा र ् य च र ण ा र ् थ म ् |
कार्यते	क ा र ् य त े |
कार्यनिरतानि	क ा र ् य न ि र त ा न ि |
कार्यप्रक्रिया	क ा र ् य प ् र क ् र ि य ा |
कार्यभारम्	क ा र ् य भ ा र म ् |
कार्यरताः	क ा र ् य र त ा ः |
कार्यवाहको	क ा र ् य व ा ह क ो |
कार्यसिद्ध्यै	क ा र ् य स ि द ् ध ् य ै |
कार्याचरणाय	क ा र ् य ा च र ण ा य |
कार्याणि	क ा र ् य ा ण ि |
कार्याणियाचरिष्यति	क ा र ् य ा ण ि य ा च र ि ष ् य त ि |
कार्याण्याचरितुं	क ा र ् य ा ण ् य ा च र ि त ु ं |
कार्याण्याचरिष्यति	क ा र ् य ा ण ् य ा च र ि ष ् य त ि |
कार्यान्वयनयोजनां	क ा र ् य ा न ् व य न य ो ज न ा ं |
कार्यान्वयनस्य	क ा र ् य ा न ् व य न स ् य |
कार्यान्वयनार्थं	क ा र ् य ा न ् व य न ा र ् थ ं |
कार्यान्वयनेषु	क ा र ् य ा न ् व य न े ष ु |
कार्यार्थं	क ा र ् य ा र ् थ ं |
कार्यालयात्	क ा र ् य ा ल य ा त ् |
कार्येषु	क ा र ् य े ष ु |
काल	क ा ल |
कालग्रासी	क ा ल ग ् र ा स ी |
कालादि	क ा ल ा द ि |
कालावदौ	क ा ल ा व द ौ |
कालीन	क ा ल ी न |
किं	क ि ं |
किंग्स्एलेवन्पंजाबक्रीडकाः	क ि ं ग ् स ् ए ल े व न ् प ं ज ा ब क ् र ी ड क ा ः |
किंग्स्क्रीडकाः	क ि ं ग ् स ् क ् र ी ड क ा ः |
किञ्चित्	क ि ञ ् च ि त ् |
किञ्चित्वक्तुकामोस्मि	क ि ञ ् च ि त ् व क ् त ु क ा म ो स ् म ि |
किञ्चिदपि	क ि ञ ् च ि द प ि |
किन्तु	क ि न ् त ु |
किमपि	क ि म प ि |
किमर्थं	क ि म र ् थ ं |
किम्	क ि म ् |
किरण	क ि र ण |
किल	क ि ल |
किशोर्योः	क ि श ो र ् य ो ः |
किश्तवाडजनपदे	क ि श ् त व ा ड ज न प द े |
कुचित्	क ु च ि त ् |
कुटि	क ु ट ि |
कुटुम्बिनः	क ु ट ु म ् ब ि न ः |
कुण्डल	क ु ण ् ड ल |
कुतः	क ु त ः |
कुतो	क ु त ो |
कुत्रचित्	क ु त ् र च ि त ् |
कुत्वा	क ु त ् व ा |
कुदस्थलात्	क ु द स ् थ ल ा त ् |
कुपवाडा	क ु प व ा ड ा |
कुमारं	क ु म ा र ं |
कुरु	क ु र ु |
कुर्दिस्तानक्षेत्रे	क ु र ् द ि स ् त ा न क ् ष े त ् र े |
कुर्म	क ु र ् म |
कुर्मः	क ु र ् म ः |
कुर्वतस्सृष्टि	क ु र ् व त स ् स ृ ष ् ट ि |
कुर्वन्ति	क ु र ् व न ् त ि |
कुर्वाणाः	क ु र ् व ा ण ा ः |
कुर्वीत	क ु र ् व ी त |
कुलपतिः	क ु ल प त ि ः |
कुल्गामजनपदे	क ु ल ् ग ा म ज न प द े |
कुसीदमितिव्यवकलनसीमा	क ु स ी द म ि त ि व ् य व क ल न स ी म ा |
कुसुमाञ्जलीन्	क ु स ु म ा ञ ् ज ल ी न ् |
कुसुमाञ्ज्लीन्	क ु स ु म ा ञ ् ज ् ल ी न ् |
कूपपतितस्य	क ू प प त ि त स ् य |
कूपे	क ू प े |
कृच्छ्रादिकं	क ृ च ् छ ् र ा द ि क ं |
कृत	क ृ त |
कृतं	क ृ त ं |
कृतः	क ृ त ः |
कृतज्ञ	क ृ त ज ् ञ |
कृतभूरि	क ृ त भ ू र ि |
कृतम्	क ृ त म ् |
कृतवान्	क ृ त व ा न ् |
कृतस्य	क ृ त स ् य |
कृता	क ृ त ा |
कृताकृतानि	क ृ त ा क ृ त ा न ि |
कृतिरियं	क ृ त ि र ि य ं |
कृते	क ृ त े |
कृत्तिकातः	क ृ त ् त ि क ा त ः |
कृत्वा	क ृ त ् व ा |
कृत्वाततः	क ृ त ् व ा त त ः |
कृत्सनमपि	क ृ त ् स न म प ि |
कृत्स्नस्य	क ृ त ् स ् न स ् य |
कृपालुः	क ृ प ा ल ु ः |
कृषकविकास	क ृ ष क व ि क ा स |
कृषकाणां	क ृ ष क ा ण ा ं |
कृषागोपयोजनायः	क ृ ष ा ग ो प य ो ज न ा य ः |
कृषि	क ृ ष ि |
कृषिवैज्ञानिकाः	क ृ ष ि व ै ज ् ञ ा न ि क ा ः |
कृष्णः	क ृ ष ् ण ः |
कृष्णश्रितः	क ृ ष ् ण श ् र ि त ः |
कृष्ण्ण	क ृ ष ् ण ् ण |
के	क े |
केंजी	क े ं ज ी |
केचन	क े च न |
केचन्द्रशेखररावः	क े च न ् द ् र श े ख र र ा व ः |
केजरीवालस्य	क े ज र ी व ा ल स ् य |
केजरीवालाय	क े ज र ी व ा ल ा य |
केजरीवालेन	क े ज र ी व ा ल े न |
केन	क े न |
केनापि	क े न ा प ि |
केन्द्र	क े न ् द ् र |
केन्द्रं	क े न ् द ् र ं |
केन्द्रस्य	क े न ् द ् र स ् य |
केन्द्रीय	क े न ् द ् र ी य |
केन्द्रीयः	क े न ् द ् र ी य ः |
केन्द्रीयमाध्यमिक्शिक्षा	क े न ् द ् र ी य म ा ध ् य म ि क ् श ि क ् ष ा |
केन्द्रीयवनपर्यावरणमन्त्रिणा	क े न ् द ् र ी य व न प र ् य ा व र ण म न ् त ् र ि ण ा |
केन्द्रीयस्वास्थ्य	क े न ् द ् र ी य स ् व ा स ् थ ् य |
केन्द्रीयान्वीक्षण	क े न ् द ् र ी य ा न ् व ी क ् ष ण |
केन्द्रीयान्वीक्षणविभागः	क े न ् द ् र ी य ा न ् व ी क ् ष ण व ि भ ा ग ः |
केन्द्रीयान्वीक्षणविभागे	क े न ् द ् र ी य ा न ् व ी क ् ष ण व ि भ ा ग े |
केन्द्रीयान्वीक्षणाभिकरणीयेन	क े न ् द ् र ी य ा न ् व ी क ् ष ण ा भ ि क र ण ी य े न |
केन्द्रीयान्वीक्षणाभिकरणेन	क े न ् द ् र ी य ा न ् व ी क ् ष ण ा भ ि क र ण े न |
केन्द्रीयायव्यय	क े न ् द ् र ी य ा य व ् य य |
केन्द्रीयारक्षिता	क े न ् द ् र ी य ा र क ् ष ि त ा |
केन्द्रीयो	क े न ् द ् र ी य ो |
केन्द्रे	क े न ् द ् र े |
केन्द्रेण	क े न ् द ् र े ण |
केरल	क े र ल |
केरलराज्यं	क े र ल र ा ज ् य ं |
केरले	क े र ल े |
केवल	क े व ल |
केवलं	क े व ल ं |
केशाकेशि	क े श ा क े श ि |
केश्रीकान्तश्च	क े श ् र ी क ा न ् त श ् च |
केषाञ्चन्	क े ष ा ञ ् च न ् |
केषुचित्	क े ष ु च ि त ् |
कैप्टन्अजयसिंगयादवः	क ै प ् ट न ् अ ज य स ि ं ग य ा द व ः |
कैरीः	क ै र ी ः |
कैलाशसत्यार्थी	क ै ल ा श स त ् य ा र ् थ ी |
कॉंन्ग्रेस्दलेन	क ॉ ं न ् ग ् र े स ् द ल े न |
कॉन्ग्रेस	क ॉ न ् ग ् र े स |
कॉन्ग्रेसदलयोः	क ॉ न ् ग ् र े स द ल य ो ः |
कॉन्ग्रेसनेता	क ॉ न ् ग ् र े स न े त ा |
कॉन्ग्रेसराष्ट्रवादि	क ॉ न ् ग ् र े स र ा ष ् ट ् र व ा द ि |
कॉन्ग्रेस्	क ॉ न ् ग ् र े स ् |
कॉन्ग्रेस्उपाध्यक्षः	क ॉ न ् ग ् र े स ् उ प ा ध ् य क ् ष ः |
कॉन्ग्रेस्दलाध्यक्षया	क ॉ न ् ग ् र े स ् द ल ा ध ् य क ् ष य ा |
कॉन्ग्रेस्दलीयं	क ॉ न ् ग ् र े स ् द ल ी य ं |
कॉन्ग्रेस्दलीयः	क ॉ न ् ग ् र े स ् द ल ी य ः |
कॉन्ग्रेस्दलेन	क ॉ न ् ग ् र े स ् द ल े न |
कॉन्ग्रेस्सन्नीतानि	क ॉ न ् ग ् र े स ् स न ् न ी त ा न ि |
को	क ो |
कोकराझार	क ो क र ा झ ा र |
कोटि	क ो ट ि |
कोटिरूप्यकाणि	क ो ट ि र ू प ् य क ा ण ि |
कोटिरूप्यकात्मक्	क ो ट ि र ू प ् य क ा त ् म क ् |
कोना	क ो न ा |
कोपि	क ो प ि |
कोपिकरोति	क ो प ि क र ो त ि |
कोलकातानाईट्राइडर्स्क्रीडकैः	क ो ल क ा त ा न ा ई ट ् र ा इ ड र ् स ् क ् र ी ड क ै ः |
कोलकातानाईट्राइडर्स्वृन्देन	क ो ल क ा त ा न ा ई ट ् र ा इ ड र ् स ् व ृ न ् द े न |
कोलकातायां	क ो ल क ा त ा य ा ं |
कोलाहल	क ो ल ा ह ल |
कोलिजियमइति	क ो ल ि ज ि य म इ त ि |
कोस्टारिकाक्रीडकान्	क ो स ् ट ा र ि क ा क ् र ी ड क ा न ् |
कौनंतेय	क ौ न ं त े य |
कौशिक	क ौ श ि क |
क्रम	क ् र म |
क्रमपाठः	क ् र म प ा ठ ः |
क्रमेषु	क ् र म े ष ु |
क्रयप्रक्रिया	क ् र य प ् र क ् र ि य ा |
क्रिकेट्	क ् र ि क े ट ् |
क्रिकेट्क्रीडकेत्तर	क ् र ि क े ट ् क ् र ी ड क े त ् त र |
क्रिकेट्द्वन्द्वे	क ् र ि क े ट ् द ् व न ् द ् व े |
क्रिकेट्स्पर्धा	क ् र ि क े ट ् स ् प र ् ध ा |
क्रियते	क ् र ि य त े |
क्रियन्ते	क ् र ि य न ् त े |
क्रियमाणं	क ् र ि य म ा ण ं |
क्रियमाणाः	क ् र ि य म ा ण ा ः |
क्रियया	क ् र ि य य ा |
क्रिया	क ् र ि य ा |
क्रियाः	क ् र ि य ा ः |
क्रियाकारे	क ् र ि य ा क ा र े |
क्रियात्मकः	क ् र ि य ा त ् म क ः |
क्रियादृश्यते	क ् र ि य ा द ृ श ् य त े |
क्रियाभवति	क ् र ि य ा भ व त ि |
क्रीडाः	क ् र ी ड ा ः |
क्रीडितुम	क ् र ी ड ि त ु म |
क्रीडोपकरणानाम्	क ् र ी ड ो प क र ण ा न ा म ् |
क्रीतम्	क ् र ी त म ् |
क्वचित्	क ् व च ि त ् |
क्षणं	क ् ष ण ं |
क्षणः	क ् ष ण ः |
क्षणे	क ् ष ण े |
क्षतिपूर्तिराशि	क ् ष त ि प ू र ् त ि र ा श ि |
क्षतिपूर्तिराशिं	क ् ष त ि प ू र ् त ि र ा श ि ं |
क्षमतावसरान्	क ् ष म त ा व स र ा न ् |
क्षमिष्यन्ते	क ् ष म ि ष ् य न ् त े |
क्षमीकरणार्थं	क ् ष म ी क र ण ा र ् थ ं |
क्षमीकरणेन	क ् ष म ी क र ण े न |
क्षमीकृतसुशासनस्य	क ् ष म ी क ृ त स ु श ा स न स ् य |
क्षिप्रमेव	क ् ष ि प ् र म े व |
क्षीरं	क ् ष ी र ं |
क्षेत्रं	क ् ष े त ् र ं |
क्षेत्रीय	क ् ष े त ् र ी य |
क्षेत्रीयसहयोगसंघटनस्यसदस्यदेशेषु	क ् ष े त ् र ी य स ह य ो ग स ं घ ट न स ् य स द स ् य द े श े ष ु |
क्षेत्रीयाः	क ् ष े त ् र ी य ा ः |
क्षेत्रे	क ् ष े त ् र े |
क्षेत्रेषु	क ् ष े त ् र े ष ु |
खण्डाः	ख ण ् ड ा ः |
खलु	ख ल ु |
खादति	ख ा द त ि |
खाद्यान्नसेवाः	ख ा द ् य ा न ् न स े व ा ः |
खेबरपख्तुन्वाजनपदे	ख े ब र प ख ् त ु न ् व ा ज न प द े |
ख्याति	ख ् य ा त ि |
ख्यापयिष्यति	ख ् य ा प य ि ष ् य त ि |
ख्यापितम्	ख ् य ा प ि त म ् |
ग	ग |
गगननारंगेण	ग ग न न ा र ं ग े ण |
गच्छन्तः	ग च ् छ न ् त ः |
गजः	ग ज ः |
गणे	ग ण े |
गत	ग त |
गतः	ग त ः |
गतम्	ग त म ् |
गतवासरे	ग त व ा स र े |
गतसप्टेम्बरमासस्य	ग त स प ् ट े म ् ब र म ा स स ् य |
गतानि	ग त ा न ि |
गत्या	ग त ् य ा |
गन्तुं	ग न ् त ु ं |
गभीरावस्थायां	ग भ ी र ा व स ् थ ा य ा ं |
गमिष्यति	ग म ि ष ् य त ि |
गम्यते	ग म ् य त े |
गाज़ा	ग ा ज ़ ा |
गाज़ायां	ग ा ज ़ ा य ा ं |
गाजाक्षेत्रे	ग ा ज ा क ् ष े त ् र े |
गानपते	ग ा न प त े |
गाने	ग ा न े |
गान्धि	ग ा न ् ध ि |
गान्धिनं	ग ा न ् ध ि न ं |
गान्धी	ग ा न ् ध ी |
गान्धीनगरे	ग ा न ् ध ी न ग र े |
गार्ह्यकर्मणामुक्तेरनन्तरं	ग ा र ् ह ् य क र ् म ण ा म ु क ् त े र न न ् त र ं |
गार्ह्यकर्माणि	ग ा र ् ह ् य क र ् म ा ण ि |
गार्ह्याणि	ग ा र ् ह ् य ा ण ि |
गार्ह्यार्थं	ग ा र ् ह ् य ा र ् थ ं |
गीतं	ग ी त ं |
गीता	ग ी त ा |
गीताः	ग ी त ा ः |
गीतासु	ग ी त ा स ु |
गीतोक्ता	ग ी त ो क ् त ा |
गुजरातभवने	ग ु ज र ा त भ व न े |
गुजरातराज्यस्य	ग ु ज र ा त र ा ज ् य स ् य |
गुजरातस्य	ग ु ज र ा त स ् य |
गुजराते	ग ु ज र ा त े |
गुजरात्रक्षिबलेन	ग ु ज र ा त ् र क ् ष ि ब ल े न |
गुजरात्विधानसभायाः	ग ु ज र ा त ् व ि ध ा न स भ ा य ा ः |
गुटखाताम्बूलसौगन्धिकानाम्	ग ु ट ख ा त ा म ् ब ू ल स ौ ग न ् ध ि क ा न ा म ् |
गुणवत्तायुतोत्पादनक्षमतां	ग ु ण व त ् त ा य ु त ो त ् प ा द न क ् ष म त ा ं |
गुप्तिस्थात्रमेकं	ग ु प ् त ि स ् थ ा त ् र म े क ं |
गुरु	ग ु र ु |
गुरुर्ब्रह्मा	ग ु र ु र ् ब ् र ह ् म ा |
गुरुर्विष्णुर्गुरुर्देवो	ग ु र ु र ् व ि ष ् ण ु र ् ग ु र ु र ् द े व ो |
गुरुस्साक्षात्	ग ु र ु स ् स ा क ् ष ा त ् |
गुरोः	ग ु र ो ः |
गुलमुहम्मद्भटः	ग ु ल म ु ह म ् म द ् भ ट ः |
गुल्मः	ग ु ल ् म ः |
गुहां	ग ु ह ा ं |
गुह्य	ग ु ह ् य |
गुह्यसम्मत्या	ग ु ह ् य स म ् म त ् य ा |
गृह	ग ृ ह |
गृहं	ग ृ ह ं |
गृहम्	ग ृ ह म ् |
गृहस्थस्य	ग ृ ह स ् थ स ् य |
गृहस्सेन	ग ृ ह स ् स े न |
गृहाणि	ग ृ ह ा ण ि |
गृहिणीनाञ्च	ग ृ ह ि ण ी न ा ञ ् च |
गृहेषु	ग ृ ह े ष ु |
गृह्णन्ति	ग ृ ह ् ण न ् त ि |
गृह्य	ग ृ ह ् य |
गृह्यते	ग ृ ह ् य त े |
गृह्यसूत्र	ग ृ ह ् य स ू त ् र |
गृह्यस्य	ग ृ ह ् य स ् य |
गृह्याणि	ग ृ ह ् य ा ण ि |
गृह्यानि	ग ृ ह ् य ा न ि |
गेल्समवायीयवाति	ग े ल ् स म व ा य ी य व ा त ि |
गोटो	ग ो ट ो |
गोत्र	ग ो त ् र |
गोत्रोत्पन्नाः	ग ो त ् र ो त ् प न ् न ा ः |
गोदान	ग ो द ा न |
गोदानस्य	ग ो द ा न स ् य |
गोधूमं	ग ो ध ू म ं |
गोधूमस्य	ग ो ध ू म स ् य |
गोपाल	ग ो प ा ल |
गोपालकः	ग ो प ा ल क ः |
गोपीनाथ	ग ो प ी न ा थ |
गोपीनाथाभ्यां	ग ो प ी न ा थ ा भ ् य ा ं |
गोमतल्लिका	ग ो म त ल ् ल ि क ा |
गोरक्षितं	ग ो र क ् ष ि त ं |
गोलाघाट्क्षेत्रे	ग ो ल ा घ ा ट ् क ् ष े त ् र े |
गोलिका	ग ो ल ि क ा |
गोलिकाः	ग ो ल ि क ा ः |
गोलिकाप्रहाराः	ग ो ल ि क ा प ् र ह ा र ा ः |
गोलिकाप्रहारैः	ग ो ल ि क ा प ् र ह ा र ै ः |
गोलिकावर्षणं	ग ो ल ि क ा व र ् ष ण ं |
ग्	ग ् |
ग्ऋह्णीयुः	ग ् ऋ ह ् ण ी य ु ः |
ग्रन्थः	ग ् र न ् थ ः |
ग्रन्थस्य	ग ् र न ् थ स ् य |
ग्रन्थादपि	ग ् र न ् थ ा द प ि |
ग्रस्त	ग ् र स ् त |
ग्रस्तस्य	ग ् र स ् त स ् य |
ग्रस्ते	ग ् र स ् त े |
ग्रस्तो	ग ् र स ् त ो |
ग्रहं	ग ् र ह ं |
ग्रहकक्षायां	ग ् र ह क क ् ष ा य ा ं |
ग्रहणं	ग ् र ह ण ं |
ग्रहणसमाराम्भे	ग ् र ह ण स म ा र ा म ् भ े |
ग्रहपरि	ग ् र ह प र ि |
ग्रहिष्यति	ग ् र ह ि ष ् य त ि |
ग्रहीतम्	ग ् र ह ी त म ् |
ग्रामत्वेन	ग ् र ा म त ् व े न |
ग्रामम्	ग ् र ा म म ् |
ग्रामस्य	ग ् र ा म स ् य |
ग्रामाः	ग ् र ा म ा ः |
ग्रामीणक्षेत्रेषु	ग ् र ा म ी ण क ् ष े त ् र े ष ु |
ग्रामीणैः	ग ् र ा म ी ण ै ः |
ग्रामे	ग ् र ा म े |
ग्रामेषु	ग ् र ा म े ष ु |
ग्रासम्	ग ् र ा स म ् |
ग्राहकाः	ग ् र ा ह क ा ः |
ग्राह्य	ग ् र ा ह ् य |
ग्लास्गोनगरे	ग ् ल ा स ् ग ो न ग र े |
घटना	घ ट न ा |
घटनाः	घ ट न ा ः |
घटनायां	घ ट न ा य ा ं |
घटनायाः	घ ट न ा य ा ः |
घटनासु	घ ट न ा स ु |
घनिष्ठसमन्वयः	घ न ि ष ् ठ स म न ् व य ः |
घोषयिष्यति	घ ो ष य ि ष ् य त ि |
घोषितः	घ ो ष ि त ः |
ङ	ङ |
ङा	ङ ा |
ङ्	ङ ् |
च	च |
चकार	च क ा र |
चक्रपाणिः	च क ् र प ा ण ि ः |
चक्रुः	च क ् र ु ः |
चक्रे	च क ् र े |
चण्डीगढे	च ण ् ड ी ग ढ े |
चण्डीप्रसादभट्टः	च ण ् ड ी प ् र स ा द भ ट ् ट ः |
चतुः	च त ु ः |
चतुर्णामेव	च त ु र ् ण ा म े व |
चतुर्ण्णां	च त ु र ् ण ् ण ा ं |
चतुर्थ	च त ु र ् थ |
चतुर्दश	च त ु र ् द श |
चतुर्दशसदस्यात्मकं	च त ु र ् द श स द स ् य ा त ् म क ं |
चतुर्दशाधिकाष्ट	च त ु र ् द श ा ध ि क ा ष ् ट |
चतुर्दशोत्तरद्विसहस्रपञ्च	च त ु र ् द श ो त ् त र द ् व ि स ह स ् र प ञ ् च |
चतुर्दश्	च त ु र ् द श ् |
चतुर्भिः	च त ु र ् भ ि ः |
चतुर्वर्षात्मकं	च त ु र ् व र ् ष ा त ् म क ं |
चतुर्वर्षात्मकस्नातकपाठ्यक्रम	च त ु र ् व र ् ष ा त ् म क स ् न ा त क प ा ठ ् य क ् र म |
चतुर्वर्षात्मकस्नातकपाठ्यक्रमस्य	च त ु र ् व र ् ष ा त ् म क स ् न ा त क प ा ठ ् य क ् र म स ् य |
चतुर्विंशति	च त ु र ् व ि ं श त ि |
चतुर्विंशतिः	च त ु र ् व ि ं श त ि ः |
चतुर्विंशतिप्रश्नेषु	च त ु र ् व ि ं श त ि प ् र श ् न े ष ु |
चतुर्विंशे	च त ु र ् व ि ं श े |
चतुर्विंशेदिनाङ्के	च त ु र ् व ि ं श े द ि न ा ङ ् क े |
चतुर्षु	च त ु र ् ष ु |
चतुर्होतृरात्मस्परणानपश्यत्	च त ु र ् ह ो त ृ र ा त ् म स ् प र ण ा न प श ् य त ् |
चतुश्चत्वारिंशत्तमंवार्षिक्याः	च त ु श ् च त ् व ा र ि ं श त ् त म ं व ा र ् ष ि क ् य ा ः |
चतुष्षष्टेः	च त ु ष ् ष ष ् ट े ः |
चतुस्त्रिंशदुत्तरत्रिशतम्	च त ु स ् त ् र ि ं श द ु त ् त र त ् र ि श त म ् |
चतूरात्रं	च त ू र ा त ् र ं |
चत्वारश्चान्ये	च त ् व ा र श ् च ा न ् य े |
चत्वारि	च त ् व ा र ि |
चत्वारिंशतः	च त ् व ा र ि ं श त ः |
चत्वारिंशतो	च त ् व ा र ि ं श त ो |
चत्वारिंशद्	च त ् व ा र ि ं श द ् |
चत्वारो	च त ् व ा र ो |
चत्वार्येव	च त ् व ा र ् य े व |
चन्द्रः	च न ् द ् र ः |
चन्द्रबाबूनायडूः	च न ् द ् र ब ा ब ू न ा य ड ू ः |
चन्द्रमसौ	च न ् द ् र म स ौ |
चन्द्रमाः	च न ् द ् र म ा ः |
चन्द्रमौलिः	च न ् द ् र म ौ ल ि ः |
चन्द्रशेखररावः	च न ् द ् र श े ख र र ा व ः |
चरणञ्च	च र ण ञ ् च |
चरणद्वये	च र ण द ् व य े |
चरणबद्धरीत्या	च र ण ब द ् ध र ी त ् य ा |
चरणयोः	च र ण य ो ः |
चरणे	च र ण े |
चलचित्राभिनेत्री	च ल च ि त ् र ा भ ि न े त ् र ी |
चलति	च ल त ि |
चषकफ़ुटबॉलस्पर्धा	च ष क फ ़ ु ट ब ॉ ल स ् प र ् ध ा |
चषकीयपादकन्दुकस्पर्धा	च ष क ी य प ा द क न ् द ु क स ् प र ् ध ा |
चषकीयपादकन्दुकस्पर्धाविजयार्थं	च ष क ी य प ा द क न ् द ु क स ् प र ् ध ा व ि ज य ा र ् थ ं |
चां	च ा ं |
चांडी	च ा ं ड ी |
चाइनाओपन्बैडमिण्टन्स्पर्धामालिकायाः	च ा इ न ा ओ प न ् ब ै ड म ि ण ् ट न ् स ् प र ् ध ा म ा ल ि क ा य ा ः |
चातुर्मास्य	च ा त ु र ् म ा स ् य |
चाधिगतम्	च ा ध ि ग त म ् |
चाधृत्यापि	च ा ध ृ त ् य ा प ि |
चापि	च ा प ि |
चामृतम्	च ा म ृ त म ् |
चार्यन्ते	च ा र ् य न ् त े |
चासौ	च ा स ौ |
चाहताः	च ा ह त ा ः |
चिकित्सालये	च ि क ि त ् स ा ल य े |
चिञ्च्यते	च ि ञ ् च ् य त े |
चितः	च ि त ः |
चितैः	च ि त ै ः |
चित्क्षेत्रेषु	च ि त ् क ् ष े त ् र े ष ु |
चित्रकूटं	च ि त ् र क ू ट ं |
चिदम्बरम्	च ि द म ् ब र म ् |
चिन्तनीयो	च ि न ् त न ी य ो |
चिन्तां	च ि न ् त ा ं |
चिन्ताकरी	च ि न ् त ा क र ी |
चिन्तितमस्ति	च ि न ् त ि त म स ् त ि |
चिन्हम्	च ि न ् ह म ् |
चिरकाल	च ि र क ा ल |
चिरात्	च ि र ा त ् |
चिराद	च ि र ा द |
चिराद्	च ि र ा द ् |
चीन	च ी न |
चीनप्रवासं	च ी न प ् र व ा स ं |
चीनराष्ट्रपतिना	च ी न र ा ष ् ट ् र प त ि न ा |
चीनराष्ट्राध्यक्षेण	च ी न र ा ष ् ट ् र ा ध ् य क ् ष े ण |
चीनविदेशमन्त्री	च ी न व ि द े श म न ् त ् र ी |
चीन्विदेशमन्त्री	च ी न ् व ि द े श म न ् त ् र ी |
चीयते	च ी य त े |
चेतुं	च े त ु ं |
चेतुम्	च े त ु म ् |
चेत्	च े त ् |
चेन्नईसुपर्	च े न ् न ई स ु प र ् |
चेन्नईसुपर्किंग्स्दलेन	च े न ् न ई स ु प र ् क ि ं ग ् स ् द ल े न |
चेष्टते	च े ष ् ट त े |
चैतन्य	च ै त न ् य |
चैतन्यघनात्	च ै त न ् य घ न ा त ् |
चैतन्यस्य	च ै त न ् य स ् य |
चैतन्यस्वरूपं	च ै त न ् य स ् व र ू प ं |
चैतानि	च ै त ा न ि |
चोरभयात्	च ो र भ य ा त ् |
चौल	च ौ ल |
चौलकर्म	च ौ ल क र ् म |
चौलस्य	च ौ ल स ् य |
च्युतिरहितः	च ् य ु त ि र ह ि त ः |
छत्तीसगढे	छ त ् त ी स ग ढ े |
छत्तीसगढ्राज्यपालः	छ त ् त ी स ग ढ ् र ा ज ् य प ा ल ः |
छत्तीस्गढस्य	छ त ् त ी स ् ग ढ स ् य |
छत्वारः	छ त ् व ा र ः |
छद्मव्यवहारार्थं	छ द ् म व ् य व ह ा र ा र ् थ ं |
छन्दाकलनं	छ न ् द ा क ल न ं |
छन्दाकलनानि	छ न ् द ा क ल न ा न ि |
छन्दो	छ न ् द ो |
छात्र	छ ा त ् र |
छात्राः	छ ा त ् र ा ः |
छात्राणां	छ ा त ् र ा ण ा ं |
छात्रान्	छ ा त ् र ा न ् |
छात्रेषु	छ ा त ् र े ष ु |
छान्दसप्रयोगाः	छ ा न ् द स प ् र य ो ग ा ः |
छान्दसप्रयोगात्	छ ा न ् द स प ् र य ो ग ा त ् |
छाय	छ ा य |
छिन्नः	छ ि न ् न ः |
जंगम्	ज ं ग म ् |
जगतः	ज ग त ः |
जगति	ज ग त ि |
जगत्	ज ग त ् |
जगत्सृष्टिरक्षणं	ज ग त ् स ृ ष ् ट ि र क ् ष ण ं |
जगदित्यपि	ज ग द ि त ् य प ि |
जगद्भवतीत्यत्र	ज ग द ् भ व त ी त ् य त ् र |
जगन्नाथपुर्यां	ज ग न ् न ा थ प ु र ् य ा ं |
जघन्यतमम्	ज घ न ् य त म म ् |
जङ्गमभारवाहियानैः	ज ङ ् ग म भ ा र व ा ह ि य ा न ै ः |
जटघनादिपाठाः	ज ट घ न ा द ि प ा ठ ा ः |
जद्यू	ज द ् य ू |
जन	ज न |
जनः	ज न ः |
जनक	ज न क |
जनता	ज न त ा |
जनपददण्डाधिकारी	ज न प द द ण ् ड ा ध ि क ा र ी |
जनपदप्रशासनेन	ज न प द प ् र श ा स न े न |
जनपदशासनेन	ज न प द श ा स न े न |
जनपदसत्रन्यायालयः	ज न प द स त ् र न ् य ा य ा ल य ः |
जनपदस्य	ज न प द स ् य |
जनपदाधिकारिभिः	ज न प द ा ध ि क ा र ि भ ि ः |
जनपदे	ज न प द े |
जनपदेषु	ज न प द े ष ु |
जनयेत्	ज न य े त ् |
जनरल्	ज न र ल ् |
जनरल्दलबीरसिंहसुहागः	ज न र ल ् द ल ब ी र स ि ं ह स ु ह ा ग ः |
जनरल्सुहागेन	ज न र ल ् स ु ह ा ग े न |
जनाः	ज न ा ः |
जनादेशं	ज न ा द े श ं |
जनादेशः	ज न ा द े श ः |
जनानां	ज न ा न ा ं |
जनान्	ज न ा न ् |
जनेभ्यः	ज न े भ ् य ः |
जनैः	ज न ै ः |
जन्म	ज न ् म |
जप्य	ज प ् य |
जमीलुद्दीन्नसीरः	ज म ी ल ु द ् द ी न ् न स ी र ः |
जमुनामुख	ज म ु न ा म ु ख |
जम्मु	ज म ् म ु |
जम्मू	ज म ् म ू |
जम्मूकश्मीर	ज म ् म ू क श ् म ी र |
जम्मूकश्मीरे	ज म ् म ू क श ् म ी र े |
जम्मूजनपदस्य	ज म ् म ू ज न प द स ् य |
जम्मूश्रीनगरराष्ट्रिय	ज म ् म ू श ् र ी न ग र र ा ष ् ट ् र ि य |
जय	ज य |
जयन्तेन	ज य न ् त े न |
जरासन्धः	ज र ा स न ् ध ः |
जरासन्धयोः	ज र ा स न ् ध य ो ः |
जर्मनी	ज र ् म न ी |
जर्मनीअर्जेन्टीनादले	ज र ् म न ी अ र ् ज े न ् ट ी न ा द ल े |
जर्मनीदेशः	ज र ् म न ी द े श ः |
जर्मनीदेशीयं	ज र ् म न ी द े श ी य ं |
जर्मनीराष्द्रं	ज र ् म न ी र ा ष ् द ् र ं |
जल	ज ल |
जलं	ज ल ं |
जलपूर	ज ल प ू र |
जलमग्नमस्ति	ज ल म ग ् न म स ् त ि |
जलस्य	ज ल स ् य |
जलान्तर्वर्तिनौसैन्यपोतः	ज ल ा न ् त र ् व र ् त ि न ौ स ै न ् य प ो त ः |
जलाप्लावदुष्प्रभाविताः	ज ल ा प ् ल ा व द ु ष ् प ् र भ ा व ि त ा ः |
जलाप्लावेन	ज ल ा प ् ल ा व े न |
जलौघ	ज ल ौ घ |
जलौघदुष्प्रभाविते	ज ल ौ घ द ु ष ् प ् र भ ा व ि त े |
जलौघस्थितिः	ज ल ौ घ स ् थ ि त ि ः |
जवातिशायिरेल्यानप्रचालनञ्च	ज व ा त ि श ा य ि र े ल ् य ा न प ् र च ा ल न ञ ् च |
जवाहर्	ज व ा ह र ् |
जवीयसा	ज व ी य स ा |
जवीयस्या	ज व ी य स ् य ा |
जातं	ज ा त ं |
जातः	ज ा त ः |
जातमात्र	ज ा त म ा त ् र |
जातम्	ज ा त म ् |
जातये	ज ा त य े |
जाता	ज ा त ा |
जाताः	ज ा त ा ः |
जातानि	ज ा त ा न ि |
जान्युआरिमासे	ज ा न ् य ु आ र ि म ा स े |
जापानदेशस्य	ज ा प ा न द े श स ् य |
जापानीयः	ज ा प ा न ी य ः |
जापानीयनागरिकस्य	ज ा प ा न ी य न ा ग र ि क स ् य |
जायते	ज ा य त े |
जायत्	ज ा य त ् |
जायन्ते	ज ा य न ् त े |
जायमानो	ज ा य म ा न ो |
जावडेकरः	ज ा व ड े क र ः |
जावडेकरेण	ज ा व ड े क र े ण |
जावेद्उस्मानीवरेण	ज ा व े द ् उ स ् म ा न ी व र े ण |
जितनराममांझी	ज ि त न र ा म म ा ं झ ी |
जिन्नाह्अन्ताराष्ट्रियविमान	ज ि न ् न ा ह ् अ न ् त ा र ा ष ् ट ् र ि य व ि म ा न |
जीतू	ज ी त ू |
जीवन	ज ी व न |
जीवनसहायिप्रणाल्याम्	ज ी व न स ह ा य ि प ् र ण ा ल ् य ा म ् |
जीवनस्तरोन्नयनार्थं	ज ी व न स ् त र ो न ् न य न ा र ् थ ं |
जीवनोस्	ज ी व न ो स ् |
जीवन्तो	ज ी व न ् त ो |
जीविंशतिराष्ट्र	ज ी व ि ं श त ि र ा ष ् ट ् र |
जीविनां	ज ी व ि न ा ं |
जीविनो	ज ी व ि न ो |
जीवेत्	ज ी व े त ् |
जुलाईमासे	ज ु ल ा ई म ा स े |
जुहोति	ज ु ह ो त ि |
जूण्	ज ू ण ् |
जे	ज े |
जेटली	ज े ट ल ी |
जेडीयूइतिस्वदलीयपराजयस्य	ज े ड ी य ू इ त ि स ् व द ल ी य प र ा ज य स ् य |
जैश्ईमोहम्मद्	ज ै श ् ई म ो ह म ् म द ् |
जॉन्	ज ॉ न ् |
जॉन्कैरीः	ज ॉ न ् क ै र ी ः |
जौहरसुल्तान्चषकहॉकी	ज ौ ह र स ु ल ् त ा न ् च ष क ह ॉ क ी |
ज्ञाता	ज ् ञ ा त ा |
ज्ञानपीठपुरस्कारभाक्	ज ् ञ ा न प ी ठ प ु र स ् क ा र भ ा क ् |
ज्ञानमयं	ज ् ञ ा न म य ं |
ज्ञायन्ते	ज ् ञ ा य न ् त े |
ज्योतिश्शाग्त्त्रात्	ज ् य ो त ि श ् श ा ग ् त ् त ् र ा त ् |
ज्योतिश्शास्त्रमति	ज ् य ो त ि श ् श ा स ् त ् र म त ि |
ज्योतिश्शास्त्रमपि	ज ् य ो त ि श ् श ा स ् त ् र म प ि |
ज्योतिश्शास्त्रादेव	ज ् य ो त ि श ् श ा स ् त ् र ा द े व |
ज्योतिश्शास्त्रे	ज ् य ो त ि श ् श ा स ् त ् र े |
ज्योतिष्टोमेन	ज ् य ो त ि ष ् ट ो म े न |
ज्योतोश्शास्त्रादेवां	ज ् य ो त ो श ् श ा स ् त ् र ा द े व ा ं |
ज्वरनिवारणार्थं	ज ् व र न ि व ा र ण ा र ् थ ं |
झटिति	झ ट ि त ि |
झार्खण्डे	झ ा र ् ख ण ् ड े |
टन्	ट न ् |
टुण्डीखेलस्थले	ट ु ण ् ड ी ख े ल स ् थ ल े |
टेनिस्क्रीडिका	ट े न ि स ् क ् र ी ड ि क ा |
ट्रक्	ट ् र क ् |
ठाकुरेण	ठ ा क ु र े ण |
ड	ड |
डिसेंबर्	ड ि स े ं ब र ् |
डिसेम्बर्	ड ि स े म ् ब र ् |
डी	ड ी |
डीजलतैल	ड ी ज ल त ै ल |
डीजल्तैल	ड ी ज ल ् त ै ल |
डीजल्तैलमूल्यं	ड ी ज ल ् त ै ल म ू ल ् य ं |
डीबीटीएल्इति	ड ी ब ी ट ी ए ल ् इ त ि |
डीवीसदानन्दगौडः	ड ी व ी स द ा न न ् द ग ौ ड ः |
डॉ	ड ॉ |
डॉहर्षवर्धनः	ड ॉ ह र ् ष व र ् ध न ः |
ढाकायां	ढ ा क ा य ा ं |
त	त |
तं	त ं |
तक्तुं	त क ् त ु ं |
तटे	त ट े |
तडागे	त ड ा ग े |
तत	त त |
ततः	त त ः |
ततम्	त त म ् |
ततो	त त ो |
ततोर्	त त ो र ् |
तत्	त त ् |
तत्कथं	त त ् क थ ं |
तत्काल	त त ् क ा ल |
तत्कुरुष्व	त त ् क ु र ु ष ् व |
तत्कोटिषु	त त ् क ो ट ि ष ु |
तत्तन्मन्त्राः	त त ् त न ् म न ् त ् र ा ः |
तत्तु	त त ् त ु |
तत्र	त त ् र |
तत्रं	त त ् र ं |
तत्रप्रश्नत्रयाणां	त त ् र प ् र श ् न त ् र य ा ण ा ं |
तत्रां	त त ् र ा ं |
तत्रापि	त त ् र ा प ि |
तत्रासौ	त त ् र ा स ौ |
तत्रैव	त त ् र ै व |
तत्समीपकाल	त त ् स म ी प क ा ल |
तथ	त थ |
तथा	त थ ा |
तथां	त थ ा ं |
तथापि	त थ ा प ि |
तथैव	त थ ै व |
तथैवयज्जुहोषि	त थ ै व य ज ् ज ु ह ो ष ि |
तदनुष्ठातुं	त द न ु ष ् ठ ा त ु ं |
तदपि	त द प ि |
तदरेतत्सत्यं	त द र े त त ् स त ् य ं |
तदस्ति	त द स ् त ि |
तदा	त द ा |
तदानीं	त द ा न ी ं |
तदास्यति	त द ा स ् य त ि |
तदाहुतिपरिणात्मकं	त द ा ह ु त ि प र ि ण ा त ् म क ं |
तदीयनेत्रि	त द ी य न े त ् र ि |
तदीयमित्र	त द ी य म ि त ् र |
तदीयश्च	त द ी य श ् च |
तदीयसहयोगिनद्याश्च	त द ी य स ह य ो ग ि न द ् य ा श ् च |
तदुत्पन्नमेव	त द ु त ् प न ् न म े व |
तदुभयं	त द ु भ य ं |
तदृण	त द ृ ण |
तदेव	त द े व |
तदैव	त द ै व |
तद्	त द ् |
तद्दीय्	त द ् द ी य ् |
तद्देशीययात्रार्थं	त द ् द े श ी य य ा त ् र ा र ् थ ं |
तद्देशीयेषु	त द ् द े श ी य े ष ु |
तद्धेतु	त द ् ध े त ु |
तद्विकार	त द ् व ि क ा र |
तनू	त न ू |
तपः	त प ः |
तपसा	त प स ा |
तमभ्यर्चेत्	त म भ ् य र ् च े त ् |
तमाखूत्पादानां	त म ा ख ू त ् प ा द ा न ा ं |
तमिलनाडुराज्यस्य	त म ि ल न ा ड ु र ा ज ् य स ् य |
तमेतं	त म े त ं |
तयैतत्	त य ै त त ् |
तयोः	त य ो ः |
तयोस्संबन्धं	त य ो स ् स ं ब न ् ध ं |
तयोस्सम्बन्ध	त य ो स ् स म ् ब न ् ध |
तरेषु	त र े ष ु |
तर्क	त र ् क |
तर्पणक्रमः	त र ् प ण क ् र म ः |
तर्पणादिषु	त र ् प ण ा द ि ष ु |
तर्हि	त र ् ह ि |
तव	त व |
तसै	त स ै |
तस्मात्	त स ् म ा त ् |
तस्मिन्	त स ् म ि न ् |
तस्मिन्नग्नौ	त स ् म ि न ् न ग ् न ौ |
तस्मै	त स ् म ै |
तस्य	त स ् य |
तस्या	त स ् य ा |
तस्याः	त स ् य ा ः |
तस्यापि	त स ् य ा प ि |
तस्यै	त स ् य ै |
तहरीकएतालिबानसंघटनं	त ह र ी क ए त ा ल ि ब ा न स ं घ ट न ं |
तात्कालिकपरिवर्तनं	त ा त ् क ा ल ि क प र ि व र ् त न ं |
तात्पर्यस्य	त ा त ् प र ् य स ् य |
तादृशान्	त ा द ृ श ा न ् |
तानि	त ा न ि |
तान्	त ा न ् |
तान्त्रिकव्यूहस्य	त ा न ् त ् र ि क व ् य ू ह स ् य |
तान्त्रिकसंयुतिः	त ा न ् त ् र ि क स ं य ु त ि ः |
तान्त्रिकसंयुतिप्रशासनस्य	त ा न ् त ् र ि क स ं य ु त ि प ् र श ा स न स ् य |
तान्त्रिकसंयुतेः	त ा न ् त ् र ि क स ं य ु त े ः |
तान्यपि	त ा न ् य प ि |
तालिबानाक्रमणम्	त ा ल ि ब ा न ा क ् र म ण म ् |
तावत्	त ा व त ् |
तावत्कालपर्यन्तं	त ा व त ् क ा ल प र ् य न ् त ं |
तिथिनिर्धारणञ्चाभिलक्ष्य	त ि थ ि न ि र ् ध ा र ण ञ ् च ा भ ि ल क ् ष ् य |
तिरकित्नगरे	त ि र क ि त ् न ग र े |
तिष्ठति	त ि ष ् ठ त ि |
तिष्ठेत	त ि ष ् ठ े त |
तिष्ठेयुः	त ि ष ् ठ े य ु ः |
तिस्रः	त ि स ् र ः |
तीर्थ	त ी र ् थ |
तीर्थे	त ी र ् थ े |
तीव्रतरं	त ी व ् र त र ं |
तु	त ु |
तुर्की	त ु र ् क ी |
तृतीय	त ृ त ी य |
तृतीयं	त ृ त ी य ं |
तृतीयस्थानार्थं	त ृ त ी य स ् थ ा न ा र ् थ ं |
तृतीयायाम्	त ृ त ी य ा य ा म ् |
ते	त े |
तेन	त े न |
तेनां	त े न ा ं |
तेनापि	त े न ा प ि |
तेनेन्द्रियञ्च	त े न े न ् द ् र ि य ञ ् च |
तेनोक्तं	त े न ो क ् त ं |
तेनोदीरितं	त े न ो द ी र ि त ं |
तेपि	त े प ि |
तेपिधर्मज्ञाः	त े प ि ध र ् म ज ् ञ ा ः |
तेयज्ञाः	त े य ज ् ञ ा ः |
तेलंगाना	त े ल ं ग ा न ा |
तेलंगानाक्षेत्रेभ्यः	त े ल ं ग ा न ा क ् ष े त ् र े भ ् य ः |
तेलंगानाबस्दुर्घनायां	त े ल ं ग ा न ा ब स ् द ु र ् घ न ा य ा ं |
तेलंगानाराज्यसमितेः	त े ल ं ग ा न ा र ा ज ् य स म ि त े ः |
तेलंगानाराज्यस्य	त े ल ं ग ा न ा र ा ज ् य स ् य |
तेलंगानाराज्ये	त े ल ं ग ा न ा र ा ज ् य े |
तेलंगानाराष्ट्र	त े ल ं ग ा न ा र ा ष ् ट ् र |
तेलुगुदेशम्पार्टी	त े ल ु ग ु द े श म ् प ा र ् ट ी |
तेलुगुदेशम्पार्टीतिदलाध्यक्षो	त े ल ु ग ु द े श म ् प ा र ् ट ी त ि द ल ा ध ् य क ् ष ो |
तेषां	त े ष ा ं |
तेषामेव	त े ष ा म े व |
तेषाम्	त े ष ा म ् |
तेषु	त े ष ु |
तैः	त ै ः |
तैत्तिरीय	त ै त ् त ि र ी य |
तैस्सर्वैयपि	त ै स ् स र ् व ै य प ि |
तौ	त ौ |
त्यक्तम्	त ् य क ् त म ् |
त्यक्त्वा	त ् य क ् त ् व ा |
त्यागपत्र	त ् य ा ग प त ् र |
त्यागपत्रं	त ् य ा ग प त ् र ं |
त्यागपत्रमिदं	त ् य ा ग प त ् र म ि द ं |
त्यागपत्राणि	त ् य ा ग प त ् र ा ण ि |
त्यागाय	त ् य ा ग ा य |
त्रप्रतिपाद्यन्ते	त ् र प ् र त ि प ा द ् य न ् त े |
त्रयं	त ् र य ं |
त्रयः	त ् र य ः |
त्रयस्य	त ् र य स ् य |
त्रयाणां	त ् र य ा ण ा ं |
त्रयेण	त ् र य े ण |
त्रयोदश	त ् र य ो द श |
त्रयोदशवर्षीयेण	त ् र य ो द श व र ् ष ी य े ण |
त्रयोदशे	त ् र य ो द श े |
त्रयोविंशतिः	त ् र य ो व ि ं श त ि ः |
त्रयोविंशे	त ् र य ो व ि ं श े |
त्रिंशत्	त ् र ि ं श त ् |
त्रिंशत्तमराज्य	त ् र ि ं श त ् त म र ा ज ् य |
त्रिंशत्प्रश्नात्मकः	त ् र ि ं श त ् प ् र श ् न ा त ् म क ः |
त्रिंशद्गृहेषु	त ् र ि ं श द ् ग ृ ह े ष ु |
त्रिचतुराः	त ् र ि च त ु र ा ः |
त्रिचत्वारिंशदुत्तरपञ्चशतसदस्यात्मिकायां	त ् र ि च त ् व ा र ि ं श द ु त ् त र प ञ ् च श त स द स ् य ा त ् म ि क ा य ा ं |
त्रिदिवसीययात्रा	त ् र ि द ि व स ी य य ा त ् र ा |
त्रिभिर्	त ् र ि भ ि र ् |
त्रिलक्षरूप्यकमिता	त ् र ि ल क ् ष र ू प ् य क म ि त ा |
त्रिवर्निकः	त ् र ि व र ् न ि क ः |
त्रिवर्षात्मकं	त ् र ि व र ् ष ा त ् म क ं |
त्रिवर्षात्मकपाठ्यक्रमं	त ् र ि व र ् ष ा त ् म क प ा ठ ् य क ् र म ं |
त्रिवादनतः	त ् र ि व ा द न त ः |
त्रिशताधिकासनानि	त ् र ि श त ा ध ि क ा स न ा न ि |
त्रिशतैः	त ् र ि श त ै ः |
त्रिषु	त ् र ि ष ु |
त्रिसप्ततिवर्षीया	त ् र ि स प ् त त ि व र ् ष ी य ा |
त्रीणि	त ् र ी ण ि |
त्रीन्	त ् र ी न ् |
त्रैत	त ् र ै त |
त्रैवर्णिकानां	त ् र ै व र ् ण ि क ा न ा ं |
त्रैवर्णिकैः	त ् र ै व र ् ण ि क ै ः |
त्र्हि	त ् र ् ह ि |
त्वम्	त ् व म ् |
त्वरया	त ् व र य ा |
त्वात्	त ् व ा त ् |
त्वेन	त ् व े न |
थरुरः	थ र ु र ः |
थिम्पू	थ ि म ् प ू |
थिम्पूनगर्यां	थ ि म ् प ू न ग र ् य ा ं |
दक्षिण	द क ् ष ि ण |
दक्षिणपश्चिमीया	द क ् ष ि ण प श ् च ि म ी य ा |
दक्षिणमणे	द क ् ष ि ण म ण े |
दक्षिणापवर्ग	द क ् ष ि ण ा प व र ् ग |
दक्षिणायणे	द क ् ष ि ण ा य ण े |
दक्षिणाहुते	द क ् ष ि ण ा ह ु त े |
दक्षिय	द क ् ष ि य |
दग्धाः	द ग ् ध ा ः |
दण्डप्रदानं	द ण ् ड प ् र द ा न ं |
दण्डादण्डि	द ण ् ड ा द ण ् ड ि |
दण्डित्वान्	द ण ् ड ि त ् व ा न ् |
दत्तः	द त ् त ः |
दत्तवान्	द त ् त व ा न ् |
ददाति	द द ा त ि |
ददासि	द द ा स ि |
दद्यात्	द द ् य ा त ् |
दधि	द ध ि |
दयालउपाध्यायग्रामज्योतिर्योजनायै	द य ा ल उ प ा ध ् य ा य ग ् र ा म ज ् य ो त ि र ् य ो ज न ा य ै |
दरीदृश्यते	द र ी द ृ श ् य त े |
दर्श	द र ् श |
दर्शः	द र ् श ः |
दर्शतिथेः	द र ् श त ि थ े ः |
दर्शपूर्ण	द र ् श प ू र ् ण |
दर्शपूर्णमासयोरेव	द र ् श प ू र ् ण म ा स य ो र े व |
दर्शपूर्णमासान्	द र ् श प ू र ् ण म ा स ा न ् |
दर्शपूर्णमासौ	द र ् श प ू र ् ण म ा स ौ |
दर्शयति	द र ् श य त ि |
दर्शयन्	द र ् श य न ् |
दर्शयागे	द र ् श य ा ग े |
दर्शाख्ये	द र ् श ा ख ् य े |
दर्शितमति	द र ् श ि त म त ि |
दर्शेष्ट्यां	द र ् श े ष ् ट ् य ा ं |
दर्श्	द र ् श ् |
दल	द ल |
दलं	द ल ं |
दलनेतारो	द ल न े त ा र ो |
दलप्रबन्धकश्च	द ल प ् र ब न ् ध क श ् च |
दलबीरसिंहसुहागस्य	द ल ब ी र स ि ं ह स ु ह ा ग स ् य |
दलमहासचिवैः	द ल म ह ा स च ि व ै ः |
दलसंयुक्त	द ल स ं य ु क ् त |
दलस्य	द ल स ् य |
दलाध्यक्ष	द ल ा ध ् य क ् ष |
दलाध्यक्षः	द ल ा ध ् य क ् ष ः |
दलाध्यक्षया	द ल ा ध ् य क ् ष य ा |
दलानां	द ल ा न ा ं |
दलानाम्	द ल ा न ा म ् |
दलानि	द ल ा न ि |
दलाभ्यां	द ल ा भ ् य ा ं |
दलितानां	द ल ि त ा न ा ं |
दलीयं	द ल ी य ं |
दलीयसम्मेलनमेकम्	द ल ी य स म ् म े ल न म े क म ् |
दलीयसम्मेलनस्य	द ल ी य स म ् म े ल न स ् य |
दलीये	द ल ी य े |
दलीयैः	द ल ी य ै ः |
दलीयोपवेशनं	द ल ी य ो प व े श न ं |
दले	द ल े |
दलेन	द ल े न |
दलेषु	द ल े ष ु |
दलैः	द ल ै ः |
दल्नेतृत्वेन	द ल ् न े त ृ त ् व े न |
दल्बीरसिंहसुहागः	द ल ् ब ी र स ि ं ह स ु ह ा ग ः |
दश	द श |
दशकेभ्यः	द श क े भ ् य ः |
दशकोटिटणमितं	द श क ो ट ि ट ण म ि त ं |
दशपैलेस्टाइनजनाः	द श प ै ल े स ् ट ा इ न ज न ा ः |
दशभिः	द श भ ि ः |
दशमलवचतुर्मिततः	द श म ल व च त ु र ् म ि त त ः |
दशम्याः	द श म ् य ा ः |
दशोत्तरद्विसहस्रेति	द श ो त ् त र द ् व ि स ह स ् र े त ि |
दान	द ा न |
दानं	द ा न ं |
दि	द ि |
दिनमेकं	द ि न म े क ं |
दिनांकं	द ि न ा ं क ं |
दिनांके	द ि न ा ं क े |
दिनाङ्के	द ि न ा ङ ् क े |
दिने	द ि न े |
दिल्	द ि ल ् |
दिल्ली	द ि ल ् ल ी |
दिल्लीडिब्रूगढ्राजधानीद्रुतगामिरेल्	द ि ल ् ल ी ड ि ब ् र ू ग ढ ् र ा ज ध ा न ी द ् र ु त ग ा म ि र े ल ् |
दिल्लीप्रशासनं	द ि ल ् ल ी प ् र श ा स न ं |
दिल्लीविश्वविद्यालयः	द ि ल ् ल ी व ि श ् व व ि द ् य ा ल य ः |
दिल्ल्यां	द ि ल ् ल ् य ा ं |
दिल्ल्याः	द ि ल ् ल ् य ा ः |
दिल्ल्याम्	द ि ल ् ल ् य ा म ् |
दिवसं	द ि व स ं |
दिवसः	द ि व स ः |
दिवसमुपलक्ष्य	द ि व स म ु प ल क ् ष ् य |
दिवससमारोहे	द ि व स स म ा र ो ह े |
दिवसात्मकं	द ि व स ा त ् म क ं |
दिवसात्मके	द ि व स ा त ् म क े |
दिवसावधौ	द ि व स ा व ध ौ |
दिवसावसरे	द ि व स ा व स र े |
दिवसीयस्पर्धा	द ि व स ी य स ् प र ् ध ा |
दिवसीयान्ताराष्ट्रिय	द ि व स ी य ा न ् त ा र ा ष ् ट ् र ि य |
दिवसीये	द ि व स ी य े |
दिवसे	द ि व स े |
दिवसो	द ि व स ो |
दिशि	द ि श ि |
दीक्षान्त	द ी क ् ष ा न ् त |
दीन	द ी न |
दीनेश	द ी न े श |
दीपावलि	द ी प ा व ल ि |
दीयते	द ी य त े |
दीर्घरज्जुः	द ी र ् घ र ज ् ज ु ः |
दीर्घां	द ी र ् घ ा ं |
दीर्घावधिकवित्तीय	द ी र ् घ ा व ध ि क व ि त ् त ी य |
दुःखातीता	द ु ः ख ा त ी त ा |
दुःस्थितिः	द ु ः स ् थ ि त ि ः |
दुखं	द ु ख ं |
दुग्धकुक्कुटाण्डमत्स्योपेतानां	द ु ग ् ध क ु क ् क ु ट ा ण ् ड म त ् स ् य ो प े त ा न ा ं |
दुप्रभाविताः	द ु प ् र भ ा व ि त ा ः |
दुबईदेशे	द ु ब ई द े श े |
दुरापन्नाः	द ु र ा प न ् न ा ः |
दुरापन्नायां	द ु र ा प न ् न ा य ा ं |
दुरापन्नायाम्	द ु र ा प न ् न ा य ा म ् |
दुरापन्नेन	द ु र ा प न ् न े न |
दुरापन्नेषु	द ु र ा प न ् न े ष ु |
दुरापादितेन	द ु र ा प ा द ि त े न |
दुर्घटना	द ु र ् घ ट न ा |
दुर्घटनां	द ु र ् घ ट न ा ं |
दुर्घटनायां	द ु र ् घ ट न ा य ा ं |
दुर्घटनायाम्	द ु र ् घ ट न ा य ा म ् |
दुर्घनेयं	द ु र ् घ न े य ं |
दुर्दुरूटः	द ु र ् द ु र ू ट ः |
दुर्भाग्य	द ु र ् भ ा ग ् य |
दुर्योधनः	द ु र ् य ो ध न ः |
दुर्योधनस्य	द ु र ् य ो ध न स ् य |
दुश्यते	द ु श ् य त े |
दुष्टानि	द ु ष ् ट ा न ि |
दुष्प्रभाविताः	द ु ष ् प ् र भ ा व ि त ा ः |
दु्प्रभावितानि	द ु ् प ् र भ ा व ि त ा न ि |
दूरभाषद्वारा	द ू र भ ा ष द ् व ा र ा |
दूरभाषमाध्यमेन	द ू र भ ा ष म ा ध ् य म े न |
दूरभाषेण	द ू र भ ा ष े ण |
दूरीकर्तुं	द ू र ी क र ् त ु ं |
दूसावासेषु	द ू स ा व ा स े ष ु |
दृढतरसुरक्षाप्रबन्धमध्ये	द ृ ढ त र स ु र क ् ष ा प ् र ब न ् ध म ध ् य े |
दृढतरा	द ृ ढ त र ा |
दृढतराः	द ृ ढ त र ा ः |
दृढतरान्	द ृ ढ त र ा न ् |
दृशा	द ृ श ा |
दृश्य	द ृ श ् य |
दृश्यते	द ृ श ् य त े |
दृश्यन्ते	द ृ श ् य न ् त े |
दृष्टम्	द ृ ष ् ट म ् |
दृष्टवान्	द ृ ष ् ट व ा न ् |
दृष्टानिवा	द ृ ष ् ट ा न ि व ा |
दृष्टिपथं	द ृ ष ् ट ि प थ ं |
दृष्ट्वा	द ृ ष ् ट ् व ा |
देव	द े व |
देवता	द े व त ा |
देवताः	द े व त ा ः |
देवतात्रयं	द े व त ा त ् र य ं |
देवताभि	द े व त ा भ ि |
देवतारिश्च	द े व त ा र ि श ् च |
देवताश्च	द े व त ा श ् च |
देवताश्चेव	द े व त ा श ् च े व |
देवतोद्य	द े व त ो द ् य |
देवस्य	द े व स ् य |
देवेभ्यः	द े व े भ ् य ः |
देश	द े श |
देशं	द े श ं |
देशः	द े श ः |
देशद्रोहाभियोग	द े श द ् र ो ह ा भ ि य ो ग |
देशद्वयमध्ये	द े श द ् व य म ध ् य े |
देशद्वयस्य	द े श द ् व य स ् य |
देशभक्ति	द े श भ क ् त ि |
देशयोः	द े श य ो ः |
देशरकडित्यादिकं	द े श र क ड ि त ् य ा द ि क ं |
देशस्य	द े श स ् य |
देशाद्	द े श ा द ् |
देशानां	द े श ा न ा ं |
देशीयां	द े श ी य ा ं |
देशीयेषु	द े श ी य े ष ु |
देशीयो	द े श ी य ो |
देशे	द े श े |
देशेन	द े श े न |
देशौ	द े श ौ |
देहस्थितिमात्रं	द े ह स ् थ ि त ि म ा त ् र ं |
देहि	द े ह ि |
दैव	द ै व |
दोग्धि	द ो ग ् ध ि |
दोषाः	द ो ष ा ः |
दोषाय	द ो ष ा य |
दोषिभ्यो	द ो ष ि भ ् य ो |
दोषी	द ो ष ी |
द्यूते	द ् य ू त े |
द्रढयितुं	द ् र ढ य ि त ु ं |
द्रढयितुम्	द ् र ढ य ि त ु म ् |
द्रमात्मकः	द ् र म ा त ् म क ः |
द्रष्टव्यमेव	द ् र ष ् ट व ् य म े व |
द्रुतगतिकः	द ् र ु त ग त ि क ः |
द्रुतगतिको	द ् र ु त ग त ि क ो |
द्रुतमेव	द ् र ु त म े व |
द्रुतमेवान्वीक्षितुं	द ् र ु त म े व ा न ् व ी क ् ष ि त ु ं |
द्वन्द्वे	द ् व न ् द ् व े |
द्वयं	द ् व य ं |
द्वयमेतत्	द ् व य म े त त ् |
द्वयस्य	द ् व य स ् य |
द्वयात्	द ् व य ा त ् |
द्वयार्थं	द ् व य ा र ् थ ं |
द्वयेन	द ् व य े न |
द्वयोः	द ् व य ो ः |
द्वाचत्वारिंशत्	द ् व ा च त ् व ा र ि ं श त ् |
द्वात्रिंशत्	द ् व ा त ् र ि ं श त ् |
द्वादश	द ् व ा द श |
द्वादशहोरावधये	द ् व ा द श ह ो र ा व ध य े |
द्वादशे	द ् व ा द श े |
द्वादश्	द ् व ा द श ् |
द्वाभ्यां	द ् व ा भ ् य ा ं |
द्वाविंशतिः	द ् व ा व ि ं श त ि ः |
द्विजः	द ् व ि ज ः |
द्वितीककाण्डे	द ् व ि त ी क क ा ण ् ड े |
द्वितीय	द ् व ि त ी य |
द्वितीयं	द ् व ि त ी य ं |
द्वितीयचरणात्मकं	द ् व ि त ी य च र ण ा त ् म क ं |
द्वितीयवारं	द ् व ि त ी य व ा र ं |
द्वितीये	द ् व ि त ी य े |
द्वित्राः	द ् व ि त ् र ा ः |
द्विदिवसीययात्रा	द ् व ि द ि व स ी य य ा त ् र ा |
द्विपञ्चाशन्निमेषाधिकनववादने	द ् व ि प ञ ् च ा श न ् न ि म े ष ा ध ि क न व व ा द न े |
द्विपाक्षिकसम्बन्धान्	द ् व ि प ा क ् ष ि क स म ् ब न ् ध ा न ् |
द्विलक्षरूप्यकमितां	द ् व ि ल क ् ष र ू प ् य क म ि त ा ं |
द्विशतं	द ् व ि श त ं |
द्विशतैः	द ् व ि श त ै ः |
द्विसप्ततिमित्या	द ् व ि स प ् त त ि म ि त ् य ा |
द्विसप्तत्यधिकद्विपंचाशत्	द ् व ि स प ् त त ् य ध ि क द ् व ि प ं च ा श त ् |
द्वे	द ् व े |
द्वौ	द ् व ौ |
धटनाः	ध ट न ा ः |
धन	ध न |
धनं	ध न ं |
धनप्रकरणस्य	ध न प ् र क र ण स ् य |
धनसंग्रहं	ध न स ं ग ् र ह ं |
धनसञ्चायकानां	ध न स ञ ् च ा य क ा न ा ं |
धनस्य	ध न स ् य |
धनाः	ध न ा ः |
धर्तुं	ध र ् त ु ं |
धर्म	ध र ् म |
धर्मः	ध र ् म ः |
धर्मज्ञाः	ध र ् म ज ् ञ ा ः |
धर्मविषये	ध र ् म व ि ष य े |
धर्मशब्देन	ध र ् म श ब ् द े न |
धर्मशास्त्रसंशोधकाः	ध र ् म श ा स ् त ् र स ं श ो ध क ा ः |
धर्मसूत्रं	ध र ् म स ू त ् र ं |
धर्मसूत्रमधिकृत्य	ध र ् म स ू त ् र म ध ि क ृ त ् य |
धर्मसूत्रे	ध र ् म स ू त ् र े |
धर्मसूत्रोक्तान्	ध र ् म स ू त ् र ो क ् त ा न ् |
धर्माः	ध र ् म ा ः |
धर्माञ्श्च	ध र ् म ा ञ ् श ् च |
धर्मान्	ध र ् म ा न ् |
धातुवृत्तौ	ध ा त ु व ृ त ् त ौ |
धाराद्वयम्	ध ा र ा द ् व य म ् |
धारियिष्यन्ति	ध ा र ि य ि ष ् य न ् त ि |
धार्मिकनेतारं	ध ा र ् म ि क न े त ा र ं |
धावनाड्कैः	ध ा व न ा ड ् क ै ः |
धीवराः	ध ी व र ा ः |
धूम्रवर्तिकानां	ध ू म ् र व र ् त ि क ा न ा ं |
धृतसम्पर्काः	ध ृ त स म ् प र ् क ा ः |
धैर्येण	ध ै र ् य े ण |
ध्येयमस्ति	ध ् य े य म स ् त ि |
ध्वनिमतेन	ध ् व न ि म त े न |
ध्वांसावशेषेषु	ध ् व ा ं स ा व श े ष े ष ु |
न	न |
नक्तं	न क ् त ं |
नक्षत्राणि	न क ् ष त ् र ा ण ि |
नक्षत्रे	न क ् ष त ् र े |
नक्सलवादिहिंस्र	न क ् स ल व ा द ि ह ि ं स ् र |
नक्सल्वादिभिः	न क ् स ल ् व ा द ि भ ि ः |
नगरं	न ग र ं |
नगरस्य	न ग र स ् य |
नगरे	न ग र े |
नगर्यां	न ग र ् य ा ं |
नजीब्	न ज ी ब ् |
नदी	न द ी |
नद्यां	न द ् य ा ं |
नद्याः	न द ् य ा ः |
नमः	न म ः |
नमोवति	न म ो व त ि |
नयन्ति	न य न ् त ि |
नयामि	न य ा म ि |
नरसिंहंवर्याय	न र स ि ं ह ं व र ् य ा य |
नरस्य	न र स ् य |
नरेन्द्र	न र े न ् द ् र |
नरेन्द्रमोदिनं	न र े न ् द ् र म ो द ि न ं |
नरेन्द्रमोदिना	न र े न ् द ् र म ो द ि न ा |
नरेन्द्रमोदिने	न र े न ् द ् र म ो द ि न े |
नरेन्द्रमोदिनो	न र े न ् द ् र म ो द ि न ो |
नरेन्द्रमोदिशासन्संघटनानन्तरं	न र े न ् द ् र म ो द ि श ा स न ् स ं घ ट न ा न न ् त र ं |
नरेन्द्रमोदिसन्नीत्	न र े न ् द ् र म ो द ि स न ् न ी त ् |
नरेन्द्रमोदी	न र े न ् द ् र म ो द ी |
नरेन्द्रमोदीसन्नीतनूतनप्रशासनस्य	न र े न ् द ् र म ो द ी स न ् न ी त न ू त न प ् र श ा स न स ् य |
नरेन्द्रमोदीसन्नीतस्य	न र े न ् द ् र म ो द ी स न ् न ी त स ् य |
नव	न व |
नवतिकेन्द्रेषु	न व त ि क े न ् द ् र े ष ु |
नवदिल्यां	न व द ि ल ् य ा ं |
नवदिल्लीं	न व द ि ल ् ल ी ं |
नवदिल्ल्यां	न व द ि ल ् ल ् य ा ं |
नवदिल्ल्याम्	न व द ि ल ् ल ् य ा म ् |
नवदेहलीडिब्रूगढराजधानीद्रुतगामिरेल्	न व द े ह ल ी ड ि ब ् र ू ग ढ र ा ज ध ा न ी द ् र ु त ग ा म ि र े ल ् |
नवधाविभागस्य	न व ध ा व ि भ ा ग स ् य |
नवनियुक्तनीतीश	न व न ि य ु क ् त न ी त ी श |
नवनिर्वाचितप्रधान	न व न ि र ् व ा च ि त प ् र ध ा न |
नवनिर्वाचिताः	न व न ि र ् व ा च ि त ा ः |
नवनिर्वाचितायाः	न व न ि र ् व ा च ि त ा य ा ः |
नवपणकोत्तरैकरूप्यकमित्या	न व प ण क ो त ् त र ै क र ू प ् य क म ि त ् य ा |
नवभारतीयकर्मकराणां	न व भ ा र त ी य क र ् म क र ा ण ा ं |
नवसंख्याकानि	न व स ं ख ् य ा क ा न ि |
नवसुरक्षासाहाय्यगुल्मानि	न व स ु र क ् ष ा स ा ह ा य ् य ग ु ल ् म ा न ि |
नवाग्रयण	न व ा ग ् र य ण |
नवाज़	न व ा ज ़ |
नवाज़शरीफ़ेन	न व ा ज ़ श र ी फ ़ े न |
नवाज़्	न व ा ज ़ ् |
नवीन	न व ी न |
नवीनतम	न व ी न त म |
नवीननगरीयक्षेत्रे	न व ी न न ग र ी य क ् ष े त ् र े |
नव्	न व ् |
नष्टः	न ष ् ट ः |
नागर	न ा ग र |
नागरविकास	न ा ग र व ि क ा स |
नागरिकः	न ा ग र ि क ः |
नागरिकश्च	न ा ग र ि क श ् च |
नागरिकेभ्यः	न ा ग र ि क े भ ् य ः |
नाङ्गीकरोति	न ा ङ ् ग ी क र ो त ि |
नाथः	न ा थ ः |
नाथो	न ा थ ो |
नानक्	न ा न क ् |
नाना	न ा न ा |
नाम	न ा म |
नामदेवतोद्दा	न ा म द े व त ो द ् द ा |
नामपरावर्तनानन्तरं	न ा म प र ा व र ् त न ा न न ् त र ं |
नामपरावर्तनार्थम्	न ा म प र ा व र ् त न ा र ् थ म ् |
नामाङ्कनपत्राणां	न ा म ा ङ ् क न प त ् र ा ण ा ं |
नायडू	न ा य ड ू |
नाशयतु	न ा श य त ु |
नास्ति	न ा स ् त ि |
नि	न ि |
निकषा	न ि क ष ा |
निगदति	न ि ग द त ि |
निगदती	न ि ग द त ी |
निगदन्ति	न ि ग द न ् त ि |
निगदितं	न ि ग द ि त ं |
निगृहीतः	न ि ग ृ ह ी त ः |
निगृहीताः	न ि ग ृ ह ी त ा ः |
निग्रहणं	न ि ग ् र ह ण ं |
निग्रहणे	न ि ग ् र ह ण े |
निज	न ि ज |
निजनेतृत्वेन	न ि ज न े त ृ त ् व े न |
नितरां	न ि त र ा ं |
नितिनपटेलेन	न ि त ि न प ट े ल े न |
नित्यं	न ि त ् य ं |
नित्याः	न ि त ् य ा ः |
निदेशालयम्	न ि द े श ा ल य म ् |
निदेशालयेन	न ि द े श ा ल य े न |
निन्दां	न ि न ् द ा ं |
निपुणः	न ि प ु ण ः |
निबद्धा	न ि ब द ् ध ा |
निमग्नानां	न ि म ग ् न ा न ा ं |
निमार्जनादीनि	न ि म ा र ् ज न ा द ी न ि |
निमित्	न ि म ि त ् |
निमित्तकाः	न ि म ि त ् त क ा ः |
निमित्तानि	न ि म ि त ् त ा न ि |
निमित्तावेक्षाणि	न ि म ि त ् त ा व े क ् ष ा ण ि |
नियंत्रण्	न ि य ं त ् र ण ् |
नियंत्रण्सीम्नि	न ि य ं त ् र ण ् स ी म ् न ि |
नियत	न ि य त |
नियतांशमुक्तं	न ि य त ा ं श म ु क ् त ं |
नियन्त्रण	न ि य न ् त ् र ण |
नियन्त्रणरेखायाम्	न ि य न ् त ् र ण र े ख ा य ा म ् |
नियन्त्रणव्यवस्थायाः	न ि य न ् त ् र ण व ् य व स ् थ ा य ा ः |
नियन्त्रणाधीना	न ि य न ् त ् र ण ा ध ी न ा |
नियन्त्रणार्थं	न ि य न ् त ् र ण ा र ् थ ं |
नियन्त्रितं	न ि य न ् त ् र ि त ं |
नियमः	न ि य म ः |
नियमस्य	न ि य म स ् य |
नियमानि	न ि य म ा न ि |
नियमान्	न ि य म ा न ् |
नियमान्तर्गतं	न ि य म ा न ् त र ् ग त ं |
नियुक्तान्	न ि य ु क ् त ा न ् |
नियुक्ति	न ि य ु क ् त ि |
नियुक्तिः	न ि य ु क ् त ि ः |
नियुक्तिपद्धतिं	न ि य ु क ् त ि प द ् ध त ि ं |
नियुक्तिविषये	न ि य ु क ् त ि व ि ष य े |
नियुक्तेः	न ि य ु क ् त े ः |
नियोजितमस्ति	न ि य ो ज ि त म स ् त ि |
नियोजितानि	न ि य ो ज ि त ा न ि |
निरणैषीत्	न ि र ण ै ष ी त ् |
निरतेन	न ि र त े न |
निरदिशत्	न ि र द ि श त ् |
निरस्ताः	न ि र स ् त ा ः |
निराकर्तुं	न ि र ा क र ् त ु ं |
निराकृतं	न ि र ा क ृ त ं |
निराकृतम्	न ि र ा क ृ त म ् |
निरुद्धाः	न ि र ु द ् ध ा ः |
निरूपण	न ि र ू प ण |
निर्गतः	न ि र ् ग त ः |
निर्जनेषु	न ि र ् ज न े ष ु |
निर्णयं	न ि र ् ण य ं |
निर्णयः	न ि र ् ण य ः |
निर्णयरोधं	न ि र ् ण य र ो ध ं |
निर्णयाधानार्थम्	न ि र ् ण य ा ध ा न ा र ् थ म ् |
निर्णयाधायिकायाः	न ि र ् ण य ा ध ा य ि क ा य ा ः |
निर्णयान्	न ि र ् ण य ा न ् |
निर्णयितत्वात्	न ि र ् ण य ि त त ् व ा त ् |
निर्णयेन	न ि र ् ण य े न |
निर्णयो	न ि र ् ण य ो |
निर्णयोयम्	न ि र ् ण य ो य म ् |
निर्णायक	न ि र ् ण ा य क |
निर्णायकद्वन्द्वे	न ि र ् ण ा य क द ् व न ् द ् व े |
निर्णायके	न ि र ् ण ा य क े |
निर्णीतः	न ि र ् ण ी त ः |
निर्णीतमस्ति	न ि र ् ण ी त म स ् त ि |
निर्णीतम्	न ि र ् ण ी त म ् |
निर्णेतुं	न ि र ् ण े त ु ं |
निर्णेष्यते	न ि र ् ण े ष ् य त े |
निर्दग्धवान्	न ि र ् द ग ् ध व ा न ् |
निर्दिशति	न ि र ् द ि श त ि |
निर्दिष्टमस्ति	न ि र ् द ि ष ् ट म स ् त ि |
निर्दिष्टाः	न ि र ् द ि ष ् ट ा ः |
निर्देश	न ि र ् द े श |
निर्देशः	न ि र ् द े श ः |
निर्देशसूत्राणि	न ि र ् द े श स ू त ् र ा ण ि |
निर्देशे	न ि र ् द े श े |
निर्दोष्	न ि र ् द ो ष ् |
निर्धनताम्	न ि र ् ध न त ा म ् |
निर्धनानां	न ि र ् ध न ा न ा ं |
निर्धार्यमाण	न ि र ् ध ा र ् य म ा ण |
निर्बाध्लाभान्तरण्योजना	न ि र ् ब ा ध ् ल ा भ ा न ् त र ण ् य ो ज न ा |
निर्माणार्थं	न ि र ् म ा ण ा र ् थ ं |
निर्मितं	न ि र ् म ि त ं |
निर्मितो	न ि र ् म ि त ो |
निर्वक्ष्यति	न ि र ् व क ् ष ् य त ि |
निर्वचनं	न ि र ् व च न ं |
निर्वर्त्यते	न ि र ् व र ् त ् य त े |
निर्वाचनं	न ि र ् व ा च न ं |
निर्वाचनविभागीयप्रवक्त्रा	न ि र ् व ा च न व ि भ ा ग ी य प ् र व क ् त ् र ा |
निर्वाचनाधिकारिणः	न ि र ् व ा च न ा ध ि क ा र ि ण ः |
निर्वाचनाधिकारिणां	न ि र ् व ा च न ा ध ि क ा र ि ण ा ं |
निर्वाचनाधिकारिाण	न ि र ् व ा च न ा ध ि क ा र ि ा ण |
निर्वाचनानन्तरं	न ि र ् व ा च न ा न न ् त र ं |
निर्वाचनाभिकर्तृभि	न ि र ् व ा च न ा भ ि क र ् त ृ भ ि |
निर्वाचनायोग	न ि र ् व ा च न ा य ो ग |
निर्वाचनायोगं	न ि र ् व ा च न ा य ो ग ं |
निर्वाचनायोगः	न ि र ् व ा च न ा य ो ग ः |
निर्वाचनायोगम्	न ि र ् व ा च न ा य ो ग म ् |
निर्वाचनायोगस्य	न ि र ् व ा च न ा य ो ग स ् य |
निर्वाचनायोगेन	न ि र ् व ा च न ा य ो ग े न |
निर्वाचनायोगेन्	न ि र ् व ा च न ा य ो ग े न ् |
निर्वाचनायोगो	न ि र ् व ा च न ा य ो ग ो |
निर्वाचितानां	न ि र ् व ा च ि त ा न ा ं |
निर्विरोधं	न ि र ् व ि र ो ध ं |
निर्विरोधम्	न ि र ् व ि र ो ध म ् |
निलम्बयति	न ि ल म ् ब य त ि |
निवसन्ति	न ि व स न ् त ि |
निवसन्तो	न ि व स न ् त ो |
निवासार्थं	न ि व ा स ा र ् थ ं |
निवास्	न ि व ा स ् |
निविडद्रव्यरूपेण	न ि व ि ड द ् र व ् य र ू प े ण |
निवेदनं	न ि व े द न ं |
निवेशप्रवंचनाप्रकरणे	न ि व े श प ् र व ं च न ा प ् र क र ण े |
निवेशस्य	न ि व े श स ् य |
निशीथे	न ि श ी थ े |
निश्चलं	न ि श ् च ल ं |
निश्चेतुम्	न ि श ् च े त ु म ् |
निश्श्रेयस	न ि श ् श ् र े य स |
निषेधस्य	न ि ष े ध स ् य |
निष्कारणेन	न ि ष ् क ा र ण े न |
निष्क्रयण	न ि ष ् क ् र य ण |
निष्प्रभावीकरणाभियानं	न ि ष ् प ् र भ ा व ी क र ण ा भ ि य ा न ं |
निष्ष्रेयसप्रयोजनं	न ि ष ् ष ् र े य स प ् र य ो ज न ं |
निहतम्	न ि ह त म ् |
निहताः	न ि ह त ा ः |
नीताः	न ी त ा ः |
नीतीश्कुमारः	न ी त ी श ् क ु म ा र ः |
नीतेः	न ी त े ः |
नीदरलैण्डदेशे	न ी द र ल ै ण ् ड द े श े |
नीदरलैण्ड्सक्रीडकाः	न ी द र ल ै ण ् ड ् स क ् र ी ड क ा ः |
नीदरलैण्ड्स्दलेन	न ी द र ल ै ण ् ड ् स ् द ल े न |
नीरवः	न ी र व ः |
नीलोत्पलानि	न ी ल ो त ् प ल ा न ि |
नूतन	न ू त न |
नूतनं	न ू त न ं |
नूतनप्रशासनसंरचनां	न ू त न प ् र श ा स न स ं र च न ा ं |
नूतनप्रशासनसंरचनार्थं	न ू त न प ् र श ा स न स ं र च न ा र ् थ ं |
नूतनप्रशासनस्य	न ू त न प ् र श ा स न स ् य |
नूतनमुख्य	न ू त न म ु ख ् य |
नूतनराज्यपालो	न ू त न र ा ज ् य प ा ल ो |
नूतनशासन	न ू त न श ा स न |
नूतनाशाकिरणत्वेन	न ू त न ा श ा क ि र ण त ् व े न |
नूनं	न ू न ं |
नेता	न े त ा |
नेतानं	न े त ा न ं |
नेतारं	न े त ा र ं |
नेतारः	न े त ा र ः |
नेतुः	न े त ु ः |
नेतृ	न े त ृ |
नेतृत्व	न े त ृ त ् व |
नेतृपदविषयकः	न े त ृ प द व ि ष य क ः |
नेतृभिः	न े त ृ भ ि ः |
नेत्री	न े त ् र ी |
नेपालदेशस्य	न े प ा ल द े श स ् य |
नेयाः	न े य ा ः |
नेव	न े व |
नेशनल्कान्फ़रेन्स्दलेन	न े श न ल ् क ा न ् फ ़ र े न ् स ् द ल े न |
नेहवालः	न े ह व ा ल ः |
नैक	न ै क |
नैककोटिरूप्यकात्मकसत्यम्प्रवञ्चनाकाण्डविषयकः	न ै क क ो ट ि र ू प ् य क ा त ् म क स त ् य म ् प ् र व ञ ् च न ा क ा ण ् ड व ि ष य क ः |
नैकाघात्	न ै क ा घ ा त ् |
नैकानि	न ै क ा न ि |
नैकेषु	न ै क े ष ु |
नैतिकदायित्वस्वीकृतिपुरस्सरं	न ै त ि क द ा य ि त ् व स ् व ी क ृ त ि प ु र स ् स र ं |
नैमित्यकानि	न ै म ि त ् य क ा न ि |
नैयून्येना	न ै य ू न ् य े न ा |
नैराश्यं	न ै र ा श ् य ं |
नैर्वाचनिक	न ै र ् व ा च न ि क |
नैर्वाचनिकचिह्नप्रदर्शनार्थं	न ै र ् व ा च न ि क च ि ह ् न प ् र द र ् श न ा र ् थ ं |
नैर्वाचनिकन्यासैः	न ै र ् व ा च न ि क न ् य ा स ै ः |
नैर्वाचनिकप्रचारः	न ै र ् व ा च न ि क प ् र च ा र ः |
नैर्वाचनिकीं	न ै र ् व ा च न ि क ी ं |
नैर्वाचनिक्प्रचाराभियानानि	न ै र ् व ा च न ि क ् प ् र च ा र ा भ ि य ा न ा न ि |
नैव	न ै व |
नोबल्पुरस्कारम्	न ो ब ल ् प ु र स ् क ा र म ् |
नोवाकजोकोविचं	न ो व ा क ज ो क ो व ि च ं |
न्नमभिजायते	न ् न म भ ि ज ा य त े |
न्यगादीत्	न ् य ग ा द ी त ् |
न्यषेधीत्	न ् य ष े ध ी त ् |
न्यागादीत्	न ् य ा ग ा द ी त ् |
न्याय	न ् य ा य |
न्यायाधीशः	न ् य ा य ा ध ी श ः |
न्यायाधीशस्य	न ् य ा य ा ध ी श स ् य |
न्यायाधीशानां	न ् य ा य ा ध ी श ा न ा ं |
न्यायालयः	न ् य ा य ा ल य ः |
न्यायालयस्य	न ् य ा य ा ल य स ् य |
न्यायालयीयं	न ् य ा य ा ल य ी य ं |
न्यायालये	न ् य ा य ा ल य े |
न्यायालयेन	न ् य ा य ा ल य े न |
न्यायालयेषु	न ् य ा य ा ल य े ष ु |
न्यायिक्	न ् य ा य ि क ् |
न्यूनतमंसमर्थन	न ् य ू न त म ं स म र ् थ न |
न्यूनतमत्रिंशद्	न ् य ू न त म त ् र ि ं श द ् |
न्यूनातिन्न्यूनाः	न ् य ू न ा त ि न ् न ् य ू न ा ः |
न्यूनातिन्यूनं	न ् य ू न ा त ि न ् य ू न ं |
न्यूनायुष्मद्भ्यो	न ् य ू न ा य ु ष ् म द ् भ ् य ो |
न्यूनिकर्तुं	न ् य ू न ि क र ् त ु ं |
न्यूनिकृतः	न ् य ू न ि क ृ त ः |
न्यूनीकुर्वन्ती	न ् य ू न ी क ु र ् व न ् त ी |
न्यूयोर्क्न्यायालयेन	न ् य ू य ो र ् क ् न ् य ा य ा ल य े न |
प	प |
पंच	प ं च |
पंचत्रिंशत्	प ं च त ् र ि ं श त ् |
पंचनिमेषाधिकचतुर्वादने	प ं च न ि म े ष ा ध ि क च त ु र ् व ा द न े |
पंचमे	प ं च म े |
पंचायतसदस्यः	प ं च ा य त स द स ् य ः |
पंजाबे	प ं ज ा ब े |
पंण्डित्	प ं ण ् ड ि त ् |
पक्वापक्वमिदम्	प क ् व ा प क ् व म ि द म ् |
पक्ष	प क ् ष |
पक्षीयसम्बन्धसंवर्धन	प क ् ष ी य स म ् ब न ् ध स ं व र ् ध न |
पक्षेण	प क ् ष े ण |
पज्चसु	प ज ् च स ु |
पञ्च	प ञ ् च |
पञ्चदशमलवनवमित	प ञ ् च द श म ल व न व म ि त |
पञ्चदिवसात्	प ञ ् च द ि व स ा त ् |
पञ्चभूतः	प ञ ् च भ ू त ः |
पञ्चभूतसु	प ञ ् च भ ू त स ु |
पञ्चभूतानि	प ञ ् च भ ू त ा न ि |
पञ्चम	प ञ ् च म |
पञ्चमहाभूतानि	प ञ ् च म ह ा भ ू त ा न ि |
पञ्चम्तेषु	प ञ ् च म ् त े ष ु |
पञ्चविशेच	प ञ ् च व ि श े च |
पञ्चशतरूप्यकतः	प ञ ् च श त र ू प ् य क त ः |
पञ्चाबारक्षिबलेन	प ञ ् च ा ब ा र क ् ष ि ब ल े न |
पञ्चायतराजसंस्थानां	प ञ ् च ा य त र ा ज स ं स ् थ ा न ा ं |
पञ्चाशज्जनपद	प ञ ् च ा श ज ् ज न प द |
पञ्चाशज्जनपदेषु	प ञ ् च ा श ज ् ज न प द े ष ु |
पञ्चाशतः	प ञ ् च ा श त ः |
पञ्चाशत्	प ञ ् च ा श त ् |
पञ्चाशत्तमः	प ञ ् च ा श त ् त म ः |
पञ्चाशत्निमेषावधौ	प ञ ् च ा श त ् न ि म े ष ा व ध ौ |
पञ्चाशदधिकैक	प ञ ् च ा श द ध ि क ै क |
पञ्चाशदुत्तरैकशतं	प ञ ् च ा श द ु त ् त र ै क श त ं |
पञ्चाशद्	प ञ ् च ा श द ् |
पञ्चाशन्नाणकमिता	प ञ ् च ा श न ् न ा ण क म ि त ा |
पञ्चाशन्मीटर्पिस्टल्स्पर्धा	प ञ ् च ा श न ् म ी ट र ् प ि स ् ट ल ् स ् प र ् ध ा |
पञ्चाशन्मीटर्राइफ़ल्प्रोन्इतिस्पर्धा	प ञ ् च ा श न ् म ी ट र ् र ा इ फ ़ ल ् प ् र ो न ् इ त ि स ् प र ् ध ा |
पञ्चाशीतिकिलोग्राम्स्पर्धा	प ञ ् च ा श ी त ि क ि ल ो ग ् र ा म ् स ् प र ् ध ा |
पञ्जाब्	प ञ ् ज ा ब ् |
पञ्जीकारिता	प ञ ् ज ी क ा र ि त ा |
पञ्जीकृताः	प ञ ् ज ी क ृ त ा ः |
पटनायकः	प ट न ा य क ः |
पटलाः	प ट ल ा ः |
पट्टिका	प ट ् ट ि क ा |
पठन्ति	प ठ न ् त ि |
पठिताः	प ठ ि त ा ः |
पणकाधिक्रूप्यक	प ण क ा ध ि क ् र ू प ् य क |
पणिकर्त्तव्यास्ति	प ण ि क र ् त ् त व ् य ा स ् त ि |
पण्डित	प ण ् ड ि त |
पण्डितः	प ण ् ड ि त ः |
पण्डिताः	प ण ् ड ि त ा ः |
पण्डितानाम्	प ण ् ड ि त ा न ा म ् |
पत्तनस्य	प त ् त न स ् य |
पत्तने	प त ् त न े |
पत्रं	प त ् र ं |
पत्रकं	प त ् र क ं |
पत्रकम्	प त ् र क म ् |
पत्रकारैः	प त ् र क ा र ै ः |
पत्रकीयाः	प त ् र क ी य ा ः |
पत्रप्रक्रियायाम्	प त ् र प ् र क ् र ि य ा य ा म ् |
पत्रयोजनायाः	प त ् र य ो ज न ा य ा ः |
पत्राणि	प त ् र ा ण ि |
पत्रीयप्रक्रियां	प त ् र ी य प ् र क ् र ि य ा ं |
पत्रे	प त ् र े |
पद	प द |
पदं	प द ं |
पदक	प द क |
पदकं	प द क ं |
पदकतालिकायां	प द क त ा ल ि क ा य ा ं |
पदकानि	प द क ा न ि |
पदगोपनीयतायै	प द ग ो प न ी य त ा य ै |
पदपाठः	प द प ा ठ ः |
पदप्रत्याशिनं	प द प ् र त ् य ा श ि न ं |
पदमलङ्कुर्वाणा	प द म ल ङ ् क ु र ् व ा ण ा |
पदम्	प द म ् |
पदस्य	प द स ् य |
पदारूढा	प द ा र ू ढ ा |
पदार्थं	प द ा र ् थ ं |
पदार्थः	प द ा र ् थ ः |
पदार्थौ	प द ा र ् थ ौ |
पयः	प य ः |
परं	प र ं |
परंच	प र ं च |
परंब्रह्म	प र ं ब ् र ह ् म |
परञ्च	प र ञ ् च |
परन्तु	प र न ् त ु |
परम	प र म |
परमपि	प र म प ि |
परमसत्यं	प र म स त ् य ं |
परमाणु	प र म ा ण ु |
परमात्मा	प र म ा त ् म ा |
परमात्मानिश्चलः	प र म ा त ् म ा न ि श ् च ल ः |
परमेश्वरः	प र म े श ् व र ः |
परमेश्वरैव	प र म े श ् व र ै व |
परम्ब्रह्म	प र म ् ब ् र ह ् म |
परलोके	प र ल ो क े |
परवेज़्	प र व े ज ़ ् |
परस्परं	प र स ् प र ं |
पराक्रमी	प र ा क ् र म ी |
पराजयत	प र ा ज य त |
पराजितः	प र ा ज ि त ः |
पराजितम्	प र ा ज ि त म ् |
पराजितवन्तौ	प र ा ज ि त व न ् त ौ |
पराजित्य	प र ा ज ि त ् य |
पराभूतम्	प र ा भ ू त म ् |
पराभूय	प र ा भ ू य |
परामर्शाः	प र ा म र ् श ा ः |
परामर्शार्थं	प र ा म र ् श ा र ् थ ं |
परावर्तनार्थं	प र ा व र ् त न ा र ् थ ं |
परिकरस्य	प र ि क र स ् य |
परिकल्पनीयम्	प र ि क ल ् प न ी य म ् |
परिचयः	प र ि च य ः |
परिचर्चां	प र ि च र ् च ा ं |
परिचर्चार्थं	प र ि च र ् च ा र ् थ ं |
परिचर्चितवन्तौ	प र ि च र ् च ि त व न ् त ौ |
परिचर्चितवान्	प र ि च र ् च ि त व ा न ् |
परिचर्चिताः	प र ि च र ् च ि त ा ः |
परिचर्चितुं	प र ि च र ् च ि त ु ं |
परिचर्चिष्यते	प र ि च र ् च ि ष ् य त े |
परिचारिकाः	प र ि च ा र ि क ा ः |
परिज्ञानं	प र ि ज ् ञ ा न ं |
परिणामतः	प र ि ण ा म त ः |
परिणामाः	प र ि ण ा म ा ः |
परिणामान्	प र ि ण ा म ा न ् |
परितः	प र ि त ः |
परित्यक्तवती	प र ि त ् य क ् त व त ी |
परित्यक्ते	प र ि त ् य क ् त े |
परिदेवनानि	प र ि द े व न ा न ि |
परिपालयति	प र ि प ा ल य त ि |
परिपालितवन्तः	प र ि प ा ल ि त व न ् त ः |
परिपाल्यते	प र ि प ा ल ् य त े |
परिपूरिताः	प र ि प ू र ि त ा ः |
परिपूर्णं	प र ि प ू र ् ण ं |
परिपृच्छापत्रं	प र ि प ृ च ् छ ा प त ् र ं |
परिपृच्छ्यते	प र ि प ृ च ् छ ् य त े |
परिपृष्टः	प र ि प ृ ष ् ट ः |
परिभावनां	प र ि भ ा व न ा ं |
परिभावयिता	प र ि भ ा व य ि त ा |
परिभाशां	प र ि भ ा श ा ं |
परिभाषा	प र ि भ ा ष ा |
परिभाषायां	प र ि भ ा ष ा य ा ं |
परिवर्तितम्	प र ि व र ् त ि त म ् |
परिवर्तिषु	प र ि व र ् त ि ष ु |
परिवार	प र ि व ा र |
परिवारितम्	प र ि व ा र ि त म ् |
परिव्रजनानुमतिं	प र ि व ् र ज न ा न ु म त ि ं |
परिश्रमः	प र ि श ् र म ः |
परिश्रमाः	प र ि श ् र म ा ः |
परिश्रमेण	प र ि श ् र म े ण |
परिषदं	प र ि ष द ं |
परिषदः	प र ि ष द ः |
परिषदा	प र ि ष द ा |
परिष्कर्तुं	प र ि ष ् क र ् त ु ं |
परिष्कारौषधयः	प र ि ष ् क ा र ौ ष ध य ः |
परिष्कृत्	प र ि ष ् क ृ त ् |
परिस्थितेः	प र ि स ् थ ि त े ः |
परीक्षणं	प र ी क ् ष ण ं |
परीक्षामहे	प र ी क ् ष ा म ह े |
परीक्षायां	प र ी क ् ष ा य ा ं |
परुषतया	प र ु ष त य ा |
परेत्यद्य	प र े त ् य द ् य |
पर्चवर्षात्मकेन	प र ् च व र ् ष ा त ् म क े न |
पर्यटन	प र ् य ट न |
पर्यन्तं	प र ् य न ् त ं |
पर्यपृच्छत्	प र ् य प ृ च ् छ त ् |
पर्यवेक्षक	प र ् य व े क ् ष क |
पर्याकुलिते	प र ् य ा क ु ल ि त े |
पर्यावरण	प र ् य ा व र ण |
पर्यावरणवेत्ता	प र ् य ा व र ण व े त ् त ा |
पर्यावरणस्य	प र ् य ा व र ण स ् य |
पर्यावरणात्मिकायाः	प र ् य ा व र ण ा त ् म ि क ा य ा ः |
पर्व	प र ् व |
पर्वेदं	प र ् व े द ं |
पलाण्डूनां	प ल ा ण ् ड ू न ा ं |
पशुबन्ध	प श ु ब न ् ध |
पशुरूपाः	प श ु र ू प ा ः |
पश्चवर्ती	प श ् च व र ् त ी |
पश्चिम	प श ् च ि म |
पश्चिमीये	प श ् च ि म ी य े |
पश्चिम्बंगाल्हरियाणाबिहारतमिल्नाडुनागालैण्ड्राज्यानां	प श ् च ि म ् ब ं ग ा ल ् ह र ि य ा ण ा ब ि ह ा र त म ि ल ् न ा ड ु न ा ग ा ल ै ण ् ड ् र ा ज ् य ा न ा ं |
पश्यन्तः	प श ् य न ् त ः |
पाकयज्ञ	प ा क य ज ् ञ |
पाकयज्ञादीनां	प ा क य ज ् ञ ा द ी न ा ं |
पाकयज्ञेषु	प ा क य ज ् ञ े ष ु |
पाकिस्तानस्य	प ा क ि स ् त ा न स ् य |
पाकिस्तानाय	प ा क ि स ् त ा न ा य |
पाकिस्तानीयप्रधान	प ा क ि स ् त ा न ी य प ् र ध ा न |
पाकिस्तानीयभटाश्च	प ा क ि स ् त ा न ी य भ ट ा श ् च |
पाकिस्तानीयैः	प ा क ि स ् त ा न ी य ै ः |
पाकिस्ताने	प ा क ि स ् त ा न े |
पाकिस्तानेन	प ा क ि स ् त ा न े न |
पाकिस्तान्	प ा क ि स ् त ा न ् |
पाठ	प ा ठ |
पाठक्रमे	प ा ठ क ् र म े |
पाठश्च	प ा ठ श ् च |
पाठे	प ा ठ े |
पाणिनेः	प ा ण ि न े ः |
पाण्डवान्	प ा ण ् ड व ा न ् |
पाण्डुः	प ा ण ् ड ु ः |
पादत्राणानाम्	प ा द त ् र ा ण ा न ा म ् |
पादत्राणोद्योगाय	प ा द त ् र ा ण ो द ् य ो ग ा य |
पादोनद्विशतमितानां	प ा द ो न द ् व ि श त म ि त ा न ा ं |
पारगमन	प ा र ग म न |
पारस्परिकसम्बन्धाः	प ा र स ् प र ि क स म ् ब न ् ध ा ः |
पारस्परिकसौहार्दसंवर्धने	प ा र स ् प र ि क स ौ ह ा र ् द स ं व र ् ध न े |
पारस्परिकान्	प ा र स ् प र ि क ा न ् |
पार्टीति	प ा र ् ट ी त ि |
पार्टीदलाध्यक्षस्य	प ा र ् ट ी द ल ा ध ् य क ् ष स ् य |
पार्वण	प ा र ् व ण |
पार्श्ववर्तिनः	प ा र ् श ् व व र ् त ि न ः |
पार्श्विकाः	प ा र ् श ् व ि क ा ः |
पार्श्विकीं	प ा र ् श ् व ि क ी ं |
पार्श्वे	प ा र ् श ् व े |
पालदेव	प ा ल द े व |
पालिकायाः	प ा ल ि क ा य ा ः |
पालेन	प ा ल े न |
पि	प ि |
पिण्ड	प ि ण ् ड |
पितृ	प ि त ृ |
पितृभ्यः	प ि त ृ भ ् य ः |
पित्र्यकर्म	प ि त ् र ् य क र ् म |
पित्र्यन्यान्यपि	प ि त ् र ् य न ् य ा न ् य प ि |
पित्र्याणि	प ि त ् र ् य ा ण ि |
पिस्टल्चालन्	प ि स ् ट ल ् च ा ल न ् |
पी	प ी |
पीडिते	प ी ड ि त े |
पीडेभ्यः	प ी ड े भ ् य ः |
पीतापीतं	प ी त ा प ी त ं |
पु	प ु |
पुंछ	प ु ं छ |
पुटकम्	प ु ट क म ् |
पुणे	प ु ण े |
पुण्याह	प ु ण ् य ा ह |
पुण्याहाः	प ु ण ् य ा ह ा ः |
पुण्याहेषु	प ु ण ् य ा ह े ष ु |
पुण्याहेस्शु	प ु ण ् य ा ह े स ् श ु |
पुण्ये	प ु ण ् य े |
पुनः	प ु न ः |
पुनरुक्तिदोषः	प ु न र ु क ् त ि द ो ष ः |
पुनरूज्जीवनार्थं	प ु न र ू ज ् ज ी व न ा र ् थ ं |
पुनरेकदा	प ु न र े क द ा |
पुनर्मतदानं	प ु न र ् म त द ा न ं |
पुनर्मतदानम्	प ु न र ् म त द ा न म ् |
पुनर्वासाय	प ु न र ् व ा स ा य |
पुनर्वास्	प ु न र ् व ा स ् |
पुनारचनाधि	प ु न ा र च न ा ध ि |
पुनिकश्च	प ु न ि क श ् च |
पुरस्काराः	प ु र स ् क ा र ा ः |
पुरस्कारेण	प ु र स ् क ा र े ण |
पुरस्कारैः	प ु र स ् क ा र ै ः |
पुरस्कृत्य	प ु र स ् क ृ त ् य |
पुरस्तात्	प ु र स ् त ा त ् |
पुरस्सरं	प ु र स ् स र ं |
पुराणि	प ु र ा ण ि |
पुरातननूतननगरीयक्षेत्रेषु	प ु र ा त न न ू त न न ग र ी य क ् ष े त ् र े ष ु |
पुरुषमचर्चिकानां	प ु र ु ष म च र ् च ि क ा न ा ं |
पुरुषवक्तृत्वनिबन्धनदोषाः	प ु र ु ष व क ् त ृ त ् व न ि ब न ् ध न द ो ष ा ः |
पुरुषस्य	प ु र ु ष स ् य |
पुरुषाणां	प ु र ु ष ा ण ा ं |
पुरुषाणाम्	प ु र ु ष ा ण ा म ् |
पुरुष्याणां	प ु र ु ष ् य ा ण ा ं |
पुरोडा	प ु र ो ड ा |
पुरोडाशः	प ु र ो ड ा श ः |
पुरोडाशयागयोर्मध्ये	प ु र ो ड ा श य ा ग य ो र ् म ध ् य े |
पुर्व	प ु र ् व |
पुल्वामा	प ु ल ् व ा म ा |
पूंछ	प ू ं छ |
पूंछजनपदे	प ू ं छ ज न प द े |
पूंछराजौरीजनपदयोः	प ू ं छ र ा ज ौ र ी ज न प द य ो ः |
पूरितैःतालिबानीयैः	प ू र ि त ै ः त ा ल ि ब ा न ी य ै ः |
पूर्ण	प ू र ् ण |
पूर्णः	प ू र ् ण ः |
पूर्णतया	प ू र ् ण त य ा |
पूर्णतां	प ू र ् ण त ा ं |
पूर्णतामेष्यति	प ू र ् ण त ा म े ष ् य त ि |
पूर्णतावसरे	प ू र ् ण त ा व स र े |
पूर्णमं	प ू र ् ण म ं |
पूर्णमासयागे	प ू र ् ण म ा स य ा ग े |
पूर्णमासशब्देन	प ू र ् ण म ा स श ब ् द े न |
पूर्णमास्यां	प ू र ् ण म ा स ् य ा ं |
पूर्णमास्येष्ट्यां	प ू र ् ण म ा स ् य े ष ् ट ् य ा ं |
पूर्णा	प ू र ् ण ा |
पूर्णायाः	प ू र ् ण ा य ा ः |
पूर्णो	प ू र ् ण ो |
पूर्त्यन्तरालम्	प ू र ् त ् य न ् त र ा ल म ् |
पूर्त्यवसरे	प ू र ् त ् य व स र े |
पूर्वं	प ू र ् व ं |
पूर्वकं	प ू र ् व क ं |
पूर्वकालिकाः	प ू र ् व क ा ल ि क ा ः |
पूर्वघोषणानुसारि	प ू र ् व घ ो ष ण ा न ु स ा र ि |
पूर्वपक्ष	प ू र ् व प क ् ष |
पूर्वपक्षे	प ू र ् व प क ् ष े |
पूर्वपञ्जाब	प ू र ् व प ञ ् ज ा ब |
पूर्वमेव	प ू र ् व म े व |
पूर्वम्	प ू र ् व म ् |
पूर्वराष्ट्रपतेः	प ू र ् व र ा ष ् ट ् र प त े ः |
पूर्वैशिया	प ू र ् व ै श ि य ा |
पूर्वोत्तरायां	प ू र ् व ो त ् त र ा य ा ं |
पूर्वोपकल्पनानि	प ू र ् व ो प क ल ् प न ा न ि |
पृच्छा	प ृ च ् छ ा |
पृथक्पृथक्	प ृ थ क ् प ृ थ क ् |
पृथक्राज्य	प ृ थ क ् र ा ज ् य |
पृथग्मानदण्डानां	प ृ थ ग ् म ा न द ण ् ड ा न ा ं |
पृष्टम्	प ृ ष ् ट म ् |
पृष्ठ	प ृ ष ् ठ |
पेलेस्टाइन	प े ल े स ् ट ा इ न |
पेशावरे	प े श ा व र े |
पोषकवस्तूनाम्	प ो ष क व स ् त ू न ा म ् |
पौनः	प ौ न ः |
पौरुषेयी	प ौ र ु ष े य ी |
पौरोडाशिक	प ौ र ो ड ा श ि क |
पौर्णमास्यां	प ौ र ् ण म ा स ् य ा ं |
पौर्णम्स्यायां	प ौ र ् ण म ् स ् य ा य ा ं |
प्	प ् |
प्र	प ् र |
प्रकटयत्	प ् र क ट य त ् |
प्रकटितः	प ् र क ट ि त ः |
प्रकटितम्	प ् र क ट ि त म ् |
प्रकटिता	प ् र क ट ि त ा |
प्रकरणवशात्	प ् र क र ण व श ा त ् |
प्रकरणस्य	प ् र क र ण स ् य |
प्रकरणे	प ् र क र ण े |
प्रकाठ्	प ् र क ा ठ ् |
प्रकाण्डात्	प ् र क ा ण ् ड ा त ् |
प्रकाश	प ् र क ा श |
प्रकाशनमपि	प ् र क ा श न म प ि |
प्रकाशयद्भ्यां	प ् र क ा श य द ् भ ् य ा ं |
प्रकृतिः	प ् र क ृ त ि ः |
प्रकृतियागौ	प ् र क ृ त ि य ा ग ौ |
प्रकोष्ठम्	प ् र क ो ष ् ठ म ् |
प्रक्रिया	प ् र क ् र ि य ा |
प्रक्रियाः	प ् र क ् र ि य ा ः |
प्रक्रियायां	प ् र क ् र ि य ा य ा ं |
प्रखण्डीयनायकः	प ् र ख ण ् ड ी य न ा य क ः |
प्रगति	प ् र ग त ि |
प्रगतिं	प ् र ग त ि ं |
प्रगतिः	प ् र ग त ि ः |
प्रगतिविवरणं	प ् र ग त ि व ि व र ण ं |
प्रचण्डनिदाघतापं	प ् र च ण ् ड न ि द ा घ त ा प ं |
प्रचाराभियानेषु	प ् र च ा र ा भ ि य ा न े ष ु |
प्रचारो	प ् र च ा र ो |
प्रचाल्यमाने	प ् र च ा ल ् य म ा न े |
प्रचुरभाटक	प ् र च ु र भ ा ट क |
प्रजया	प ् र ज य ा |
प्रजा	प ् र ज ा |
प्रजाः	प ् र ज ा ः |
प्रजानघनात्	प ् र ज ा न घ न ा त ् |
प्रजापति	प ् र ज ा प त ि |
प्रजापतिः	प ् र ज ा प त ि ः |
प्रजापतेः	प ् र ज ा प त े ः |
प्रज्ञानघनः	प ् र ज ् ञ ा न घ न ः |
प्रज्ञानघनत्वं	प ् र ज ् ञ ा न घ न त ् व ं |
प्रज्ञानघनमित्यस्ति	प ् र ज ् ञ ा न घ न म ि त ् य स ् त ि |
प्रणब्	प ् र ण ब ् |
प्रणव	प ् र ण व |
प्रणवमुखर्जिनं	प ् र ण व म ु ख र ् ज ि न ं |
प्रणवमुखर्जी	प ् र ण व म ु ख र ् ज ी |
प्रणवमुखर्जीमहाभागेन	प ् र ण व म ु ख र ् ज ी म ह ा भ ा ग े न |
प्रणव्मुखर्जी	प ् र ण व ् म ु ख र ् ज ी |
प्रणालिकायांविस्फोट	प ् र ण ा ल ि क ा य ा ं व ि स ् फ ो ट |
प्रणालीं	प ् र ण ा ल ी ं |
प्रणाशितम्	प ् र ण ा श ि त म ् |
प्रति	प ् र त ि |
प्रतिज्ञां	प ् र त ि ज ् ञ ा ं |
प्रतिज्ञापनविधा	प ् र त ि ज ् ञ ा प न व ि ध ा |
प्रतिज्ञापयिष्यते	प ् र त ि ज ् ञ ा प य ि ष ् य त े |
प्रतिज्ञापयिष्यन्ते	प ् र त ि ज ् ञ ा प य ि ष ् य न ् त े |
प्रतिज्ञापितवान्	प ् र त ि ज ् ञ ा प ि त व ा न ् |
प्रतिज्ञापिताः	प ् र त ि ज ् ञ ा प ि त ा ः |
प्रतिज्ञाप्यते	प ् र त ि ज ् ञ ा प ् य त े |
प्रतिदिनं	प ् र त ि द ि न ं |
प्रतिनिधि	प ् र त ि न ि ध ि |
प्रतिनिधिमण्डलमेकम्	प ् र त ि न ि ध ि म ण ् ड ल म े क म ् |
प्रतिनिवृत्तः	प ् र त ि न ि व ृ त ् त ः |
प्रतिपादन	प ् र त ि प ा द न |
प्रतिपादितं	प ् र त ि प ा द ि त ं |
प्रतिपादितः	प ् र त ि प ा द ि त ः |
प्रतिपादितम्	प ् र त ि प ा द ि त म ् |
प्रतिपादिता	प ् र त ि प ा द ि त ा |
प्रतिबद्धता	प ् र त ि ब द ् ध त ा |
प्रतिबद्धमस्ति	प ् र त ि ब द ् ध म स ् त ि |
प्रतिबन्धादेशान्	प ् र त ि ब न ् ध ा द े श ा न ् |
प्रतिभासते	प ् र त ि भ ा स त े |
प्रतिरक्षा	प ् र त ि र क ् ष ा |
प्रतिरक्षाक्रय	प ् र त ि र क ् ष ा क ् र य |
प्रतिरक्षामन्त्रिणं	प ् र त ि र क ् ष ा म न ् त ् र ि ण ं |
प्रतिरक्षालंकरण	प ् र त ि र क ् ष ा ल ं क र ण |
प्रतिलिटर्	प ् र त ि ल ि ट र ् |
प्रतिलीटरं	प ् र त ि ल ी ट र ं |
प्रतिलीटर्	प ् र त ि ल ी ट र ् |
प्रतिवर्षम्	प ् र त ि व र ् ष म ् |
प्रतिवेशि	प ् र त ि व े श ि |
प्रतिवेशिदेशैः	प ् र त ि व े श ि द े श ै ः |
प्रतिशतं	प ् र त ि श त ं |
प्रतिशतम्	प ् र त ि श त म ् |
प्रतिश्रुतमस्ति	प ् र त ि श ् र ु त म स ् त ि |
प्रतिश्रुतमेव	प ् र त ि श ् र ु त म े व |
प्रतिश्रुतम्	प ् र त ि श ् र ु त म ् |
प्रतिश्रुतयः	प ् र त ि श ् र ु त य ः |
प्रतिश्रुतवान्	प ् र त ि श ् र ु त व ा न ् |
प्रतिषिद्धम्	प ् र त ि ष ि द ् ध म ् |
प्रतिषिद्धवान्	प ् र त ि ष ि द ् ध व ा न ् |
प्रतिषेधः	प ् र त ि ष े ध ः |
प्रतिषेधोनस्यात्	प ् र त ि ष े ध ो न स ् य ा त ् |
प्रतिष्ठापनार्थं	प ् र त ि ष ् ठ ा प न ा र ् थ ं |
प्रतिष्ठापयितुं	प ् र त ि ष ् ठ ा प य ि त ु ं |
प्रतिष्ठापितं	प ् र त ि ष ् ठ ा प ि त ं |
प्रतिष्ठापितम्	प ् र त ि ष ् ठ ा प ि त म ् |
प्रत्यक्	प ् र त ् य क ् |
प्रत्यपादयत्	प ् र त ् य प ा द य त ् |
प्रत्यवरोह	प ् र त ् य व र ो ह |
प्रत्यवरोहणार्थानि	प ् र त ् य व र ो ह ण ा र ् थ ा न ि |
प्रत्यवायभ	प ् र त ् य व ा य भ |
प्रत्यवायोत्पत्त्यवगमात्	प ् र त ् य व ा य ो त ् प त ् त ् य व ग म ा त ् |
प्रत्यहं	प ् र त ् य ह ं |
प्रत्याख्यातम्	प ् र त ् य ा ख ् य ा त म ् |
प्रत्यागच्छन्	प ् र त ् य ा ग च ् छ न ् |
प्रत्यानेतुं	प ् र त ् य ा न े त ु ं |
प्रत्यायितम्	प ् र त ् य ा य ि त म ् |
प्रत्याशित्वेन	प ् र त ् य ा श ि त ् व े न |
प्रत्याशिनः	प ् र त ् य ा श ि न ः |
प्रत्याशिनम्	प ् र त ् य ा श ि न म ् |
प्रत्युत्तरं	प ् र त ् य ु त ् त र ं |
प्रत्युत्तरितं	प ् र त ् य ु त ् त र ि त ं |
प्रत्युत्तरिष्यते	प ् र त ् य ु त ् त र ि ष ् य त े |
प्रत्यूषे	प ् र त ् य ू ष े |
प्रत्येकं	प ् र त ् य े क ं |
प्रत्येकमेकस्मै	प ् र त ् य े क म े क स ् म ै |
प्रत्येकस्मिन्	प ् र त ् य े क स ् म ि न ् |
प्रत्राणि	प ् र त ् र ा ण ि |
प्रथम	प ् र थ म |
प्रथमं	प ् र थ म ं |
प्रथमः	प ् र थ म ः |
प्रथमतः	प ् र थ म त ः |
प्रथमदिनाङ्कात्	प ् र थ म द ि न ा ङ ् क ा त ् |
प्रथमद्वितीय	प ् र थ म द ् व ि त ी य |
प्रथमन्तावत्	प ् र थ म न ् त ा व त ् |
प्रथममसृजत	प ् र थ म म स ृ ज त |
प्रथममुख्य	प ् र थ म म ु ख ् य |
प्रथमे	प ् र थ म े |
प्रदक्षिणं	प ् र द क ् ष ि ण ं |
प्रदक्षिणम्	प ् र द क ् ष ि ण म ् |
प्रदत्तमासीत्	प ् र द त ् त म ा स ी त ् |
प्रदत्तम्	प ् र द त ् त म ् |
प्रदत्ता	प ् र द त ् त ा |
प्रददाति	प ् र द द ा त ि |
प्रदर्शनम्	प ् र द र ् श न म ् |
प्रदर्शनरतानां	प ् र द र ् श न र त ा न ा ं |
प्रदर्शनानि	प ् र द र ् श न ा न ि |
प्रदर्शयता	प ् र द र ् श य त ा |
प्रदातव्यं	प ् र द ा त व ् य ं |
प्रदातुं	प ् र द ा त ु ं |
प्रदातुम्	प ् र द ा त ु म ् |
प्रदानस्य	प ् र द ा न स ् य |
प्रदानार्थं	प ् र द ा न ा र ् थ ं |
प्रदास्यते	प ् र द ा स ् य त े |
प्रदीयमानं	प ् र द ी य म ा न ं |
प्रदीयमानां	प ् र द ी य म ा न ा ं |
प्रदेशस्य	प ् र द े श स ् य |
प्रदेशे	प ् र द े श े |
प्रदेशेषु	प ् र द े श े ष ु |
प्रदोष	प ् र द ो ष |
प्रधनाहुतयः	प ् र ध न ा ह ु त य ः |
प्रधान	प ् र ध ा न |
प्रधानं	प ् र ध ा न ं |
प्रधानहवींषि	प ् र ध ा न ह व ी ं ष ि |
प्रधानाहुतय	प ् र ध ा न ा ह ु त य |
प्रधानाहुती	प ् र ध ा न ा ह ु त ी |
प्रधान्	प ् र ध ा न ् |
प्रपञ्चे	प ् र प ञ ् च े |
प्रपाठकं	प ् र प ा ठ क ं |
प्रपाठके	प ् र प ा ठ क े |
प्रपाठकेषु	प ् र प ा ठ क े ष ु |
प्रपूरणविधा	प ् र प ू र ण व ि ध ा |
प्रबलप्रत्याशिनी	प ् र ब ल प ् र त ् य ा श ि न ी |
प्रबोधिताः	प ् र ब ो ध ि त ा ः |
प्रभाते	प ् र भ ा त े |
प्रभावात्	प ् र भ ा व ा त ् |
प्रभावितेषु	प ् र भ ा व ि त े ष ु |
प्रभूतं	प ् र भ ू त ं |
प्रभूतमात्रायां	प ् र भ ू त म ा त ् र ा य ा ं |
प्रभृति	प ् र भ ृ त ि |
प्रमणं	प ् र म ण ं |
प्रमाणं	प ् र म ा ण ं |
प्रमाणत्वेन	प ् र म ा ण त ् व े न |
प्रमाणमप्यस्ति	प ् र म ा ण म प ् य स ् त ि |
प्रमाणमिति	प ् र म ा ण म ि त ि |
प्रमाणम्	प ् र म ा ण म ् |
प्रमाणितः	प ् र म ा ण ि त ः |
प्रमाणीकरिष्यन्ते	प ् र म ा ण ी क र ि ष ् य न ् त े |
प्रमुखं	प ् र म ु ख ं |
प्रमुखः	प ् र म ु ख ः |
प्रमुखवैशिष्ट्यानि	प ् र म ु ख व ै श ि ष ् ट ् य ा न ि |
प्रमुखसदस्य	प ् र म ु ख स द स ् य |
प्रमुखाणां	प ् र म ु ख ा ण ा ं |
प्रमुखाभि	प ् र म ु ख ा भ ि |
प्रमुखे	प ् र म ु ख े |
प्रमुखेन	प ् र म ु ख े न |
प्रमुखो	प ् र म ु ख ो |
प्रयतमानाः	प ् र य त म ा न ा ः |
प्रयतिता	प ् र य त ि त ा |
प्रयतिष्यते	प ् र य त ि ष ् य त े |
प्रयत्यते	प ् र य त ् य त े |
प्रयासः	प ् र य ा स ः |
प्रयासाः	प ् र य ा स ा ः |
प्रयासे	प ् र य ा स े |
प्रयासो	प ् र य ा स ो |
प्रयुत्यते	प ् र य ु त ् य त े |
प्रयोगं	प ् र य ो ग ं |
प्रयोजनं	प ् र य ो ज न ं |
प्रयोजनम्	प ् र य ो ज न म ् |
प्रयोजनानि	प ् र य ो ज न ा न ि |
प्रवक्ता	प ् र व क ् त ा |
प्रवरकाण्डञ्च	प ् र व र क ा ण ् ड ञ ् च |
प्रवर्तते	प ् र व र ् त त े |
प्रवर्तन	प ् र व र ् त न |
प्रवर्तनं	प ् र व र ् त न ं |
प्रवर्तनम्	प ् र व र ् त न म ् |
प्रवर्तनाय	प ् र व र ् त न ा य |
प्रवर्तनावसरे	प ् र व र ् त न ा व स र े |
प्रवर्तन्ते	प ् र व र ् त न ् त े |
प्रवर्तमान	प ् र व र ् त म ा न |
प्रवर्तमानवित्त	प ् र व र ् त म ा न व ि त ् त |
प्रवर्तमानविश्व	प ् र व र ् त म ा न व ि श ् व |
प्रवर्तमानानि	प ् र व र ् त म ा न ा न ि |
प्रवर्तमानायाः	प ् र व र ् त म ा न ा य ा ः |
प्रवर्तयिष्यति	प ् र व र ् त य ि ष ् य त ि |
प्रवर्तित	प ् र व र ् त ि त |
प्रवर्तितम्	प ् र व र ् त ि त म ् |
प्रवर्तिता	प ् र व र ् त ि त ा |
प्रवर्तिष्यते	प ् र व र ् त ि ष ् य त े |
प्रवर्त्यन्ते	प ् र व र ् त ् य न ् त े |
प्रवर्धितम्	प ् र व र ् ध ि त म ् |
प्रवर्ध्य	प ् र व र ् ध ् य |
प्रवहति	प ् र व ह त ि |
प्रवहन्ति	प ् र व ह न ् त ि |
प्रवास	प ् र व ा स |
प्रवासावधौ	प ् र व ा स ा व ध ौ |
प्रविष्टः	प ् र व ि ष ् ट ः |
प्रविष्टयः	प ् र व ि ष ् ट य ः |
प्रविष्टस्सन्	प ् र व ि ष ् ट स ् स न ् |
प्रविष्टाः	प ् र व ि ष ् ट ा ः |
प्रविष्ट्वा	प ् र व ि ष ् ट ् व ा |
प्रवीणः	प ् र व ी ण ः |
प्रवीणा	प ् र व ी ण ा |
प्रवुत्तिरिति	प ् र व ु त ् त ि र ि त ि |
प्रवृज्यते	प ् र व ृ ज ् य त े |
प्रवृत्तं	प ् र व ृ त ् त ं |
प्रवृत्तम्	प ् र व ृ त ् त म ् |
प्रवृत्तस्य	प ् र व ृ त ् त स ् य |
प्रवृत्तानि	प ् र व ृ त ् त ा न ि |
प्रवृत्तिम्	प ् र व ृ त ् त ि म ् |
प्रवृत्ते	प ् र व ृ त ् त े |
प्रवृद्धो	प ् र व ृ द ् ध ो |
प्रवेशस्य	प ् र व े श स ् य |
प्रवेशादि	प ् र व े श ा द ि |
प्रवेशानुज्ञा	प ् र व े श ा न ु ज ् ञ ा |
प्रवेशोत्सवे	प ् र व े श ो त ् स व े |
प्रशंसितः	प ् र श ं स ि त ः |
प्रशासन	प ् र श ा स न |
प्रशासनं	प ् र श ा स न ं |
प्रशासनम्	प ् र श ा स न म ् |
प्रशासनसंरचनाविषये	प ् र श ा स न स ं र च न ा व ि ष य े |
प्रशासनसंरचनाहेतोः	प ् र श ा स न स ं र च न ा ह े त ो ः |
प्रशासनस्य	प ् र श ा स न स ् य |
प्रशासनाभ्यां	प ् र श ा स न ा भ ् य ा ं |
प्रशासनाय	प ् र श ा स न ा य |
प्रशासनेन	प ् र श ा स न े न |
प्रशासिना	प ् र श ा स ि न ा |
प्रशिक्षण	प ् र श ि क ् ष ण |
प्रश्नः	प ् र श ् न ः |
प्रश्नद्वये	प ् र श ् न द ् व य े |
प्रश्नयोः	प ् र श ् न य ो ः |
प्रश्नान्	प ् र श ् न ा न ् |
प्रश्ने	प ् र श ् न े |
प्रसङ्गात्	प ् र स ङ ् ग ा त ् |
प्रसङ्गे	प ् र स ङ ् ग े |
प्रसज्येत	प ् र स ज ् य े त |
प्रसड्गे	प ् र स ड ् ग े |
प्रसन्नतां	प ् र स न ् न त ा ं |
प्रसारण	प ् र स ा र ण |
प्रसारयिष्यते	प ् र स ा र य ि ष ् य त े |
प्रसारितः	प ् र स ा र ि त ः |
प्रसारिते	प ् र स ा र ि त े |
प्रसार्य	प ् र स ा र ् य |
प्रसार्यमाणाः	प ् र स ा र ् य म ा ण ा ः |
प्रसिद्धः	प ् र स ि द ् ध ः |
प्रसिद्धार्थः	प ् र स ि द ् ध ा र ् थ ः |
प्रसृतमस्ति	प ् र स ृ त म स ् त ि |
प्रस्तावः	प ् र स ् त ा व ः |
प्रस्तावमेकं	प ् र स ् त ा व म े क ं |
प्रस्तावितमस्ति	प ् र स ् त ा व ि त म स ् त ि |
प्रस्तावितम्	प ् र स ् त ा व ि त म ् |
प्रस्तावितास्ति	प ् र स ् त ा व ि त ा स ् त ि |
प्रस्तुतः	प ् र स ् त ु त ः |
प्रस्तुतवान्	प ् र स ् त ु त व ा न ् |
प्रस्तूय	प ् र स ् त ू य |
प्रस्तोतुं	प ् र स ् त ो त ु ं |
प्रस्थान	प ् र स ् थ ा न |
प्रस्थास्यति	प ् र स ् थ ा स ् य त ि |
प्रस्थिताः	प ् र स ् थ ि त ा ः |
प्रस्थितानां	प ् र स ् थ ि त ा न ा ं |
प्रस्थिते	प ् र स ् थ ि त े |
प्रहरि	प ् र ह र ि |
प्रहलमित्	प ् र ह ल म ि त ् |
प्रहारक	प ् र ह ा र क |
प्रहारेषु	प ् र ह ा र े ष ु |
प्रहृत्य	प ् र ह ृ त ् य |
प्रह्यो	प ् र ह ् य ो |
प्राकटयत्	प ् र ा क ट य त ् |
प्राकृतिक	प ् र ा क ृ त ि क |
प्राक्	प ् र ा क ् |
प्राक्कालिकाः	प ् र ा क ् क ा ल ि क ा ः |
प्राक्तन	प ् र ा क ् त न |
प्राक्तनं	प ् र ा क ् त न ं |
प्राक्तना	प ् र ा क ् त न ा |
प्राक्नैर्वाचनिकपरिणामविश्लेषणं	प ् र ा क ् न ै र ् व ा च न ि क प र ि ण ा म व ि श ् ल े ष ण ं |
प्राक्परिणामविश्लेषणानि	प ् र ा क ् प र ि ण ा म व ि श ् ल े ष ण ा न ि |
प्रागप	प ् र ा ग प |
प्रागेव	प ् र ा ग े व |
प्राग्	प ् र ा ग ् |
प्राचीनं	प ् र ा च ी न ं |
प्राचीननगरीयक्षेत्रे	प ् र ा च ी न न ग र ी य क ् ष े त ् र े |
प्राचीनावीतिना	प ् र ा च ी न ा व ी त ि न ा |
प्राचीरात्	प ् र ा च ी र ा त ् |
प्राचीलेखा	प ् र ा च ी ल े ख ा |
प्राजापत्य	प ् र ा ज ा प त ् य |
प्राण	प ् र ा ण |
प्राणं	प ् र ा ण ं |
प्राणः	प ् र ा ण ः |
प्राणचेष्टनेन	प ् र ा ण च े ष ् ट न े न |
प्राणयवेवि	प ् र ा ण य व े व ि |
प्राणस्य	प ् र ा ण स ् य |
प्राणस्यैव	प ् र ा ण स ् य ै व |
प्राणात्	प ् र ा ण ा त ् |
प्राणादग्निर्जातः	प ् र ा ण ा द ग ् न ि र ् ज ा त ः |
प्राणादिकं	प ् र ा ण ा द ि क ं |
प्राणै	प ् र ा ण ै |
प्राणो	प ् र ा ण ो |
प्राणोजायते	प ् र ा ण ो ज ा य त े |
प्राणोनाम	प ् र ा ण ो न ा म |
प्रातः	प ् र ा त ः |
प्रातःसङ्गवं	प ् र ा त ः स ङ ् ग व ं |
प्रातरेकादशवादनात्	प ् र ा त र े क ा द श व ा द न ा त ् |
प्राथमिकताकार्यपद्धत्योः	प ् र ा थ म ि क त ा क ा र ् य प द ् ध त ् य ो ः |
प्राथमिकी	प ् र ा थ म ि क ी |
प्राथम्यं	प ् र ा थ म ् य ं |
प्राथम्येन	प ् र ा थ म ् य े न |
प्राथम्येशु	प ् र ा थ म ् य े श ु |
प्रादर्शि	प ् र ा द र ् श ि |
प्रादात्	प ् र ा द ा त ् |
प्राधान्यं	प ् र ा ध ा न ् य ं |
प्रान्ते	प ् र ा न ् त े |
प्रापिताः	प ् र ा प ि त ा ः |
प्रापितानि	प ् र ा प ि त ा न ि |
प्राप्तः	प ् र ा प ् त ः |
प्राप्तानि	प ् र ा प ् त ा न ि |
प्राप्तुं	प ् र ा प ् त ु ं |
प्राप्तेषु	प ् र ा प ् त े ष ु |
प्राप्यते	प ् र ा प ् य त े |
प्राभाषत	प ् र ा भ ा ष त |
प्राभाषत्	प ् र ा भ ा ष त ् |
प्रामाण्यं	प ् र ा म ा ण ् य ं |
प्रायः	प ् र ा य ः |
प्रायशः	प ् र ा य श ः |
प्रायश्चित्त	प ् र ा य श ् च ि त ् त |
प्रायश्चित्तः	प ् र ा य श ् च ि त ् त ः |
प्रायाश्च	प ् र ा य ा श ् च |
प्रायेण	प ् र ा य े ण |
प्रारंभं	प ् र ा र ं भ ं |
प्रार्थितम्	प ् र ा र ् थ ि त म ् |
प्रावधत्तानि	प ् र ा व ध त ् त ा न ि |
प्रावधातुं	प ् र ा व ध ा त ु ं |
प्रावधानम्	प ् र ा व ध ा न म ् |
प्रावर्तन्त	प ् र ा व र ् त न ् त |
प्रावर्तयत्	प ् र ा व र ् त य त ् |
प्रावृटः	प ् र ा व ृ ट ः |
प्रावृट्	प ् र ा व ृ ट ् |
प्रावोचत्	प ् र ा व ो च त ् |
प्राशासनिककार्यालयाः	प ् र ा श ा स न ि क क ा र ् य ा ल य ा ः |
प्राशासनिकस्रोतसामनुसारि	प ् र ा श ा स न ि क स ् र ो त स ा म न ु स ा र ि |
प्रासारयत्	प ् र ा स ा र य त ् |
प्रास्तौत्	प ् र ा स ् त ौ त ् |
प्रेषयितुं	प ् र े ष य ि त ु ं |
प्रेषयिष्यन्ते	प ् र े ष य ि ष ् य न ् त े |
प्रेषितस्य	प ् र े ष ि त स ् य |
प्रेषिताः	प ् र े ष ि त ा ः |
प्रोक्तं	प ् र ो क ् त ं |
प्रोक्तम्	प ् र ो क ् त म ् |
प्रोक्ताः	प ् र ो क ् त ा ः |
प्रोत्साहयितुं	प ् र ो त ् स ा ह य ि त ु ं |
प्रोत्साहितवान्	प ् र ो त ् स ा ह ि त व ा न ् |
फलं	फ ल ं |
फलस्तीनोग्रवादिभिः	फ ल स ् त ी न ो ग ् र व ा द ि भ ि ः |
फलानि	फ ल ा न ि |
फलिते	फ ल ि त े |
फ़ीफ़ाइतिविश्व	फ ़ ी फ ़ ा इ त ि व ि श ् व |
फ़ीफ़ाविश्व	फ ़ ी फ ़ ा व ि श ् व |
फ़ोर्टलेज़ानगरे	फ ़ ो र ् ट ल े ज ़ ा न ग र े |
फ़्रन्च्ओपन्टेनिस्मालिकायां	फ ़ ् र न ् च ् ओ प न ् ट े न ि स ् म ा ल ि क ा य ा ं |
फ़्रेन्च्ओपन्टेनिस्	फ ़ ् र े न ् च ् ओ प न ् ट े न ि स ् |
फीफाविश्व	फ ी फ ा व ि श ् व |
फुटमितं	फ ु ट म ि त ं |
फ्रान्क्फ़ुट्	फ ् र ा न ् क ् फ ़ ु ट ् |
बंगलूरुनगरे	ब ं ग ल ू र ु न ग र े |
बंगालखातिरवर्तत	ब ं ग ा ल ख ा त ि र व र ् त त |
बंगालझार्खण्डबिहारराज्यानि	ब ं ग ा ल झ ा र ् ख ण ् ड ब ि ह ा र र ा ज ् य ा न ि |
बंगालस्य	ब ं ग ा ल स ् य |
बंगाले	ब ं ग ा ल े |
बगरादस्थः	ब ग र ा द स ् थ ः |
बदायूजनपदे	ब द ा य ू ज न प द े |
बद्ध्यते	ब द ् ध ् य त े |
बन्धकी	ब न ् ध क ी |
बभूवुः	ब भ ू व ु ः |
बर्दवानविस्फोटकाण्डस्य	ब र ् द व ा न व ि स ् फ ो ट क ा ण ् ड स ् य |
बलं	ब ल ं |
बलराम्जीदासटण्डनः	ब ल र ा म ् ज ी द ा स ट ण ् ड न ः |
बलस्य	ब ल स ् य |
बलानि	ब ल ा न ि |
बलुचिस्तानप्रान्ते	ब ल ु च ि स ् त ा न प ् र ा न ् त े |
बलेन	ब ल े न |
बलैः	ब ल ै ः |
बलैश्च	ब ल ै श ् च |
बसयानस्य	ब स य ा न स ् य |
बस्	ब स ् |
बहवः	ब ह व ः |
बहवो	ब ह व ो |
बहादुर्शास्त्रिणंश्च	ब ह ा द ु र ् श ा स ् त ् र ि ण ं श ् च |
बहिः	ब ह ि ः |
बहुकोणीया	ब ह ु क ो ण ी य ा |
बहुपक्षीयाः	ब ह ु प क ् ष ी य ा ः |
बहुमतं	ब ह ु म त ं |
बहुमतेन	ब ह ु म त े न |
बहुमानानन्तरं	ब ह ु म ा न ा न न ् त र ं |
बहुलाभकरं	ब ह ु ल ा भ क र ं |
बहुषु	ब ह ु ष ु |
बहुसफ़ला	ब ह ु स फ ़ ल ा |
बहूनि	ब ह ू न ि |
बांग्ला	ब ा ं ग ् ल ा |
बांग्लादेशः	ब ा ं ग ् ल ा द े श ः |
बांग्लादेशविदेशमन्त्री	ब ा ं ग ् ल ा द े श व ि द े श म न ् त ् र ी |
बांग्लादेशीयपर्यटकाणां	ब ा ं ग ् ल ा द े श ी य प र ् य ट क ा ण ा ं |
बांग्लादेशीयप्रवासेन	ब ा ं ग ् ल ा द े श ी य प ् र व ा स े न |
बांग्लादेशीयविदेश	ब ा ं ग ् ल ा द े श ी य व ि द े श |
बादार्थं	ब ा द ा र ् थ ं |
बाधाः	ब ा ध ा ः |
बाधिता	ब ा ध ि त ा |
बारामूलालोकसभासनार्थं	ब ा र ा म ू ल ा ल ो क स भ ा स न ा र ् थ ं |
बारामूलासंसदीयक्षेत्रे	ब ा र ा म ू ल ा स ं स द ी य क ् ष े त ् र े |
बारासाट्बसिरहाट्जाय्नगर्संसदीय	ब ा र ा स ा ट ् ब स ि र ह ा ट ् ज ा य ् न ग र ् स ं स द ी य |
बालकः	ब ा ल क ः |
बालकल्याणार्थं	ब ा ल क ल ् य ा ण ा र ् थ ं |
बालकाः	ब ा ल क ा ः |
बालतलपहलगामयोः	ब ा ल त ल प ह ल ग ा म य ो ः |
बालाकोट	ब ा ल ा क ो ट |
बालाधिकारकार्यकर्ता	ब ा ल ा ध ि क ा र क ा र ् य क र ् त ा |
बालान्	ब ा ल ा न ् |
बालिकाश्चासन्	ब ा ल ि क ा श ् च ा स न ् |
बाहूबाहवि	ब ा ह ू ब ा ह व ि |
बिडालस्य	ब ि ड ा ल स ् य |
बिस्मिल्लाह्खानस्य	ब ि स ् म ि ल ् ल ा ह ् ख ा न स ् य |
बिहार	ब ि ह ा र |
बिहारमुख्य	ब ि ह ा र म ु ख ् य |
बिहारराज्ये	ब ि ह ा र र ा ज ् य े |
बिहारे	ब ि ह ा र े |
बिहार्	ब ि ह ा र ् |
बीजूजनतादलविधायक	ब ी ज ू ज न त ा द ल व ि ध ा य क |
बुज	ब ु ज |
बुद्धिभिः	ब ु द ् ध ि भ ि ः |
बुधवासरे	ब ु ध व ा स र े |
बुलन्दशहर्रक्षिस्थात्रे	ब ु ल न ् द श ह र ् र क ् ष ि स ् थ ा त ् र े |
बृहत्तमं	ब ृ ह त ् त म ं |
बृहदारण्यके	ब ृ ह द ा र ण ् य क े |
बृहदारण्यकेपि	ब ृ ह द ा र ण ् य क े प ि |
बृहदारमिके	ब ृ ह द ा र म ि क े |
बृहन्मात्रिकम्	ब ृ ह न ् म ा त ् र ि क म ् |
बृहस्पतिवासरे	ब ृ ह स ् प त ि व ा स र े |
बेंगलूरु	ब े ं ग ल ू र ु |
बेदी	ब े द ी |
बेनियाबागस्थले	ब े न ि य ा ब ा ग स ् थ ल े |
बेन्जामिननेतन्याहुमहोदयम्	ब े न ् ज ा म ि न न े त न ् य ा ह ु म ह ो द य म ् |
बैंकेषु	ब ै ं क े ष ु |
बोडोलैण्ड्एरिया	ब ो ड ो ल ै ण ् ड ् ए र ि य ा |
बोधायनसूत्रसामान्यः	ब ो ध ा य न स ू त ् र स ा म ा न ् य ः |
बोधायनसूत्रात्	ब ो ध ा य न स ू त ् र ा त ् |
बोम्बेउच्च	ब ो म ् ब े उ च ् च |
बौधायनं	ब ौ ध ा य न ं |
बौधायनः	ब ौ ध ा य न ः |
बौधायनसूत्रात्	ब ौ ध ा य न स ू त ् र ा त ् |
ब्रह्म	ब ् र ह ् म |
ब्रह्मचर्यानुष्ठानं	ब ् र ह ् म च र ् य ा न ु ष ् ठ ा न ं |
ब्रह्मचर्येण	ब ् र ह ् म च र ् य े ण |
ब्राज़ीलदेशं	ब ् र ा ज ़ ी ल द े श ं |
ब्राज़ीलवृन्दम्	ब ् र ा ज ़ ी ल व ृ न ् द म ् |
ब्राज़ीले	ब ् र ा ज ़ ी ल े |
ब्राहः	ब ् र ा ह ः |
ब्राह्मणं	ब ् र ा ह ् म ण ं |
ब्राह्मणः	ब ् र ा ह ् म ण ः |
ब्राह्मणम्	ब ् र ा ह ् म ण म ् |
ब्राह्मणा	ब ् र ा ह ् म ण ा |
ब्राह्मणात्मकौ	ब ् र ा ह ् म ण ा त ् म क ौ |
ब्राह्मणे	ब ् र ा ह ् म ण े |
ब्रिक्स	ब ् र ि क ् स |
ब्रिक्स्शिखरोपवेशनात्	ब ् र ि क ् स ् श ि ख र ो प व े श न ा त ् |
ब्रिस्बेन्नगरे	ब ् र ि स ् ब े न ् न ग र े |
ब्लोग्	ब ् ल ो ग ् |
भक्तानां	भ क ् त ा न ा ं |
भगवतः	भ ग व त ः |
भगवता	भ ग व त ा |
भगवताः	भ ग व त ा ः |
भगवतीनगराधार	भ ग व त ी न ग र ा ध ा र |
भगवान्	भ ग व ा न ् |
भङ्गः	भ ङ ् ग ः |
भजते	भ ज त े |
भजिष्यति	भ ज ि ष ् य त ि |
भटाः	भ ट ा ः |
भटोपि	भ ट ो प ि |
भट्ट	भ ट ् ट |
भणितं	भ ण ि त ं |
भद्र	भ द ् र |
भद्रतरस्वास्थ	भ द ् र त र स ् व ा स ् थ |
भद्रतरस्वास्थ्य	भ द ् र त र स ् व ा स ् थ ् य |
भद्रतां	भ द ् र त ा ं |
भद्रतामवेक्ष्य	भ द ् र त ा म व े क ् ष ् य |
भवति	भ व त ि |
भवतिस	भ व त ि स |
भवतीति	भ व त ी त ि |
भवतीत्युक्ते	भ व त ी त ् य ु क ् त े |
भवने	भ व न े |
भवन्ति	भ व न ् त ि |
भवाः	भ व ा ः |
भविता	भ व ि त ा |
भवितारः	भ व ि त ा र ः |
भवितुमर्हति	भ व ि त ु म र ् ह त ि |
भवितुम्	भ व ि त ु म ् |
भविष्यतः	भ व ि ष ् य त ः |
भविष्यति	भ व ि ष ् य त ि |
भवेच्चेत्	भ व े च ् च े त ् |
भवेत्	भ व े त ् |
भवेयुः	भ व े य ु ः |
भागस्य	भ ा ग स ् य |
भागे	भ ा ग े |
भागेभ्यः	भ ा ग े भ ् य ः |
भागेषु	भ ा ग े ष ु |
भाजपा	भ ा ज प ा |
भाजपादलप्रवक्त्रा	भ ा ज प ा द ल प ् र व क ् त ् र ा |
भाजपादलाध्यक्षेण	भ ा ज प ा द ल ा ध ् य क ् ष े ण |
भाजपादलेन	भ ा ज प ा द ल े न |
भाजपानेता	भ ा ज प ा न े त ा |
भाजपानेतृषु	भ ा ज प ा न े त ृ ष ु |
भाजपानेत्री	भ ा ज प ा न े त ् र ी |
भाजपाप्रधान	भ ा ज प ा प ् र ध ा न |
भाजपाशिव	भ ा ज प ा श ि व |
भाजपासंसदीय	भ ा ज प ा स ं स द ी य |
भाजपासंसदीयपरिषद्	भ ा ज प ा स ं स द ी य प र ि ष द ् |
भाजपासंसदीयमण्डलस्य	भ ा ज प ा स ं स द ी य म ण ् ड ल स ् य |
भाजपासन्नीता	भ ा ज प ा स न ् न ी त ा |
भाज्पा	भ ा ज ् प ा |
भाटक	भ ा ट क |
भाति	भ ा त ि |
भारं	भ ा र ं |
भारत	भ ा र त |
भारतं	भ ा र त ं |
भारतंबांग्लादेशेन	भ ा र त ं ब ा ं ग ् ल ा द े श े न |
भारतइज़रायलदेशयोर्	भ ा र त इ ज ़ र ा य ल द े श य ो र ् |
भारतचीन	भ ा र त च ी न |
भारतपाकिस्तानसीम्नि	भ ा र त प ा क ि स ् त ा न स ी म ् न ि |
भारतभूटानयोः	भ ा र त भ ू ट ा न य ो ः |
भारतस्य	भ ा र त स ् य |
भारतामेरिकासम्भाषणोपवेशने	भ ा र त ा म े र ि क ा स म ् भ ा ष ण ो प व े श न े |
भारतिये	भ ा र त ि य े |
भारतीय	भ ा र त ी य |
भारतीयकर्मकराणां	भ ा र त ी य क र ् म क र ा ण ा ं |
भारतीयकृष्यनुसन्धानपरिषदः	भ ा र त ी य क ृ ष ् य न ु स न ् ध ा न प र ि ष द ः |
भारतीयक्रिकेट्क्रीडक	भ ा र त ी य क ् र ि क े ट ् क ् र ी ड क |
भारतीयक्रीडकैः	भ ा र त ी य क ् र ी ड क ै ः |
भारतीयजनतापार्टीति	भ ा र त ी य ज न त ा प ा र ् ट ी त ि |
भारतीयजनतापार्टीतिदलेनोक्तं	भ ा र त ी य ज न त ा प ा र ् ट ी त ि द ल े न ो क ् त ं |
भारतीयतटरक्षिभिः	भ ा र त ी य त ट र क ् ष ि भ ि ः |
भारतीयदूतावासः	भ ा र त ी य द ू त ा व ा स ः |
भारतीयदूतावासप्रमुखैः	भ ा र त ी य द ू त ा व ा स प ् र म ु ख ै ः |
भारतीयदूरसंचारनियामकप्राधिकरणपरिष्कार	भ ा र त ी य द ू र स ं च ा र न ि य ा म क प ् र ा ध ि क र ण प र ि ष ् क ा र |
भारतीयधीवराः	भ ा र त ी य ध ी व र ा ः |
भारतीयनौसैनायै	भ ा र त ी य न ौ स ै न ा य ै |
भारतीयपरिचारिकाणां	भ ा र त ी य प र ि च ा र ि क ा ण ा ं |
भारतीयपरिचारिकाणाम्	भ ा र त ी य प र ि च ा र ि क ा ण ा म ् |
भारतीयपारगमन	भ ा र त ी य प ा र ग म न |
भारतीयप्रतिनिधि	भ ा र त ी य प ् र त ि न ि ध ि |
भारतीयप्रशासनाय	भ ा र त ी य प ् र श ा स न ा य |
भारतीयप्रशासनेन	भ ा र त ी य प ् र श ा स न े न |
भारतीयभूभागेषु	भ ा र त ी य भ ू भ ा ग े ष ु |
भारतीयमत्स्य	भ ा र त ी य म त ् स ् य |
भारतीयरक्षि	भ ा र त ी य र क ् ष ि |
भारतीयरिज़र्वबैंकं	भ ा र त ी य र ि ज ़ र ् व ब ै ं क ं |
भारतीयवाणिज्यदूतावासं	भ ा र त ी य व ा ण ि ज ् य द ू त ा व ा स ं |
भारतीयवाणिज्यदूतावासमालक्ष्य	भ ा र त ी य व ा ण ि ज ् य द ू त ा व ा स म ा ल क ् ष ् य |
भारतीयवाणिज्यदूतावासस्य	भ ा र त ी य व ा ण ि ज ् य द ू त ा व ा स स ् य |
भारतीयवायु	भ ा र त ी य व ा य ु |
भारतीयविदेश	भ ा र त ी य व ि द े श |
भारतीयविदेशमन्त्रिणा	भ ा र त ी य व ि द े श म न ् त ् र ि ण ा |
भारतीयसैन्य	भ ा र त ी य स ै न ् य |
भारतीयाः	भ ा र त ी य ा ः |
भारतीयातंरिक्षानुसंधान	भ ा र त ी य ा त ं र ि क ् ष ा न ु स ं ध ा न |
भारतीयानां	भ ा र त ी य ा न ा ं |
भारतीयायुर्विज्ञान	भ ा र त ी य ा य ु र ् व ि ज ् ञ ा न |
भारते	भ ा र त े |
भारतेन	भ ा र त े न |
भारमित्	भ ा र म ि त ् |
भारसमर्पणाय	भ ा र स म र ् प ण ा य |
भारस्वीकरणार्थम्	भ ा र स ् व ी क र ण ा र ् थ म ् |
भारोत्तोलनक्रीडायां	भ ा र ो त ् त ो ल न क ् र ी ड ा य ा ं |
भार्या	भ ा र ् य ा |
भार्यां	भ ा र ् य ा ं |
भावनया	भ ा व न य ा |
भावनांशत्रयमिति	भ ा व न ा ं श त ् र य म ि त ि |
भावयन्	भ ा व य न ् |
भावसिक्ताः	भ ा व स ि क ् त ा ः |
भावि	भ ा व ि |
भाविस्थल	भ ा व ि स ् थ ल |
भाषणे	भ ा ष ण े |
भाषमाण	भ ा ष म ा ण |
भाषमाणः	भ ा ष म ा ण ः |
भाषमाणा	भ ा ष म ा ण ा |
भाषितभाषात्वेन	भ ा ष ि त भ ा ष ा त ् व े न |
भाष्य	भ ा ष ् य |
भाष्यकाराः	भ ा ष ् य क ा र ा ः |
भाष्यमकुर्वन्	भ ा ष ् य म क ु र ् व न ् |
भाष्ये	भ ा ष ् य े |
भास्कराः	भ ा स ् क र ा ः |
भिन्नः	भ ि न ् न ः |
भिभाषणस्य	भ ि भ ा ष ण स ् य |
भीतिः	भ ी त ि ः |
भीमसेन	भ ी म स े न |
भीमसेनस्य	भ ी म स े न स ् य |
भीमसेनेन	भ ी म स े न े न |
भीषणझञ्झावातेन	भ ी ष ण झ ञ ् झ ा व ा त े न |
भीषणानि	भ ी ष ण ा न ि |
भुक्ताभुक्तं	भ ु क ् त ा भ ु क ् त ं |
भुवनेश्वरे	भ ु व न े श ् व र े |
भूटान	भ ू ट ा न |
भूटानप्रधान	भ ू ट ा न प ् र ध ा न |
भूटानयोः	भ ू ट ा न य ो ः |
भूटानस्य	भ ू ट ा न स ् य |
भूतं	भ ू त ं |
भूतबलिः	भ ू त ब ल ि ः |
भूतये	भ ू त य े |
भूतस्य	भ ू त स ् य |
भूताः	भ ू त ा ः |
भूपेन्द्र	भ ू प े न ् द ् र |
भूमिकां	भ ू म ि क ा ं |
भूम्पस्यास्य	भ ू म ् प स ् य ा स ् य |
भूयसीं	भ ू य स ी ं |
भूरि	भ ू र ि |
भूस्खलनस्य	भ ू स ् ख ल न स ् य |
भूस्खलनात्	भ ू स ् ख ल न ा त ् |
भृशम्	भ ृ श म ् |
भेदनकेन्द्रात्	भ े द न क े न ् द ् र ा त ् |
भैषज्यच्छात्राः	भ ै ष ज ् य च ् छ ा त ् र ा ः |
भैषज्यानुसंधान	भ ै ष ज ् य ा न ु स ं ध ा न |
भैषज्यानुसंधानं	भ ै ष ज ् य ा न ु स ं ध ा न ं |
भोजः	भ ो ज ः |
भोजनं	भ ो ज न ं |
भोजनावकाशानन्तरं	भ ो ज न ा व क ा श ा न न ् त र ं |
भोजोत्सवे	भ ो ज ो त ् स व े |
भ्रमणार्थं	भ ् र म ण ा र ् थ ं |
भ्रातृसमः	भ ् र ा त ृ स म ः |
मंगल	म ं ग ल |
मंगलकक्षायां	म ं ग ल क क ् ष ा य ा ं |
मंगलयानमेतत्	म ं ग ल य ा न म े त त ् |
मंगल्	म ं ग ल ् |
मंत्रालयस्य	म ं त ् र ा ल य स ् य |
मंत्रि	म ं त ् र ि |
मंत्रिणः	म ं त ् र ि ण ः |
मंत्रिणा	म ं त ् र ि ण ा |
मंत्री	म ं त ् र ी |
मंत्रीमहोदयं	म ं त ् र ी म ह ो द य ं |
मङ्गल	म ङ ् ग ल |
मङ्गलयानमेतत्	म ङ ् ग ल य ा न म े त त ् |
मङ्गला	म ङ ् ग ल ा |
मज्जिताः	म ज ् ज ि त ा ः |
मड्गलवासरे	म ड ् ग ल व ा स र े |
मण	म ण |
मण्डलं	म ण ् ड ल ं |
मण्डलम्	म ण ् ड ल म ् |
मण्डलस्य	म ण ् ड ल स ् य |
मण्डलीयक्रीडा	म ण ् ड ल ी य क ् र ी ड ा |
मण्डलीयनियुक्तिसमित्या	म ण ् ड ल ी य न ि य ु क ् त ि स म ि त ् य ा |
मण्डलीयसहकर्मिणः	म ण ् ड ल ी य स ह क र ् म ि ण ः |
मतगणना	म त ग ण न ा |
मतगणनादिवसे	म त ग ण न ा द ि व स े |
मतदातृन्	म त द ा त ृ न ् |
मतदानं	म त द ा न ं |
मतदानकेन्द्रे	म त द ा न क े न ् द ् र े |
मतदानकेन्द्रेषु	म त द ा न क े न ् द ् र े ष ु |
मतदानप्रवृत्तीनां	म त द ा न प ् र व ृ त ् त ी न ा ं |
मतदानम्	म त द ा न म ् |
मतभे	म त भ े |
मतभेदाः	म त भ े द ा ः |
मतमिदं	म त म ि द ं |
मतम्	म त म ् |
मताकलनाय	म त ा क ल न ा य |
मतिः	म त ि ः |
मतिभेदः	म त ि भ े द ः |
मते	म त े |
मत्रालयः	म त ् र ा ल य ः |
मत्स्य	म त ् स ् य |
मथित्वा	म थ ि त ् व ा |
मदर्पणं	म द र ् प ण ं |
मदर्पणम्	म द र ् प ण म ् |
मध्य	म ध ् य |
मध्यप्रदेशे	म ध ् य प ् र द े श े |
मध्यम	म ध ् य म |
मध्यादृनः	म ध ् य ा द ृ न ः |
मध्याह्न	म ध ् य ा ह ् न |
मध्ये	म ध ् य े |
मध्येमार्गं	म ध ् य े म ा र ् ग ं |
मनः	म न ः |
मनमोहनसिंहः	म न म ो ह न स ि ं ह ः |
मनसि	म न स ि |
मनुः	म न ु ः |
मनुष्यः	म न ु ष ् य ः |
मनुष्यबुद्धे	म न ु ष ् य ब ु द ् ध े |
मनुष्यमात्रं	म न ु ष ् य म ा त ् र ं |
मनुष्या	म न ु ष ् य ा |
मनुष्यास्सन्ति	म न ु ष ् य ा स ् स न ् त ि |
मनुष्येण	म न ु ष ् य े ण |
मनुस्मृतौ	म न ु स ् म ृ त ौ |
मनुस्स्मृतौ	म न ु स ् स ् म ृ त ौ |
मनोय्	म न ो य ् |
मनोहर	म न ो ह र |
मन्त्र	म न ् त ् र |
मन्त्रं	म न ् त ् र ं |
मन्त्रणाम्	म न ् त ् र ण ा म ् |
मन्त्रब्राह्मणाभ्यां	म न ् त ् र ब ् र ा ह ् म ण ा भ ् य ा ं |
मन्त्रयिष्यति	म न ् त ् र य ि ष ् य त ि |
मन्त्रविभागैव	म न ् त ् र व ि भ ा ग ै व |
मन्त्राः	म न ् त ् र ा ः |
मन्त्राण	म न ् त ् र ा ण |
मन्त्राणां	म न ् त ् र ा ण ा ं |
मन्त्रार्थ	म न ् त ् र ा र ् थ |
मन्त्रार्थः	म न ् त ् र ा र ् थ ः |
मन्त्रालयस्य	म न ् त ् र ा ल य स ् य |
मन्त्रालयस्यप्रवक्ता	म न ् त ् र ा ल य स ् य प ् र व क ् त ा |
मन्त्रालयानां	म न ् त ् र ा ल य ा न ा ं |
मन्त्रालयीयस्रोतसामनुसारि	म न ् त ् र ा ल य ी य स ् र ो त स ा म न ु स ा र ि |
मन्त्रालयेन	म न ् त ् र ा ल य े न |
मन्त्रि	म न ् त ् र ि |
मन्त्रिकृषिसेचनयोजनायै	म न ् त ् र ि क ृ ष ि स े च न य ो ज न ा य ै |
मन्त्रिणं	म न ् त ् र ि ण ं |
मन्त्रिणः	म न ् त ् र ि ण ः |
मन्त्रिणा	म न ् त ् र ि ण ा |
मन्त्रिणां	म न ् त ् र ि ण ा ं |
मन्त्रिणे	म न ् त ् र ि ण े |
मन्त्रिणो	म न ् त ् र ि ण ो |
मन्त्रिणौ	म न ् त ् र ि ण ौ |
मन्त्रितवान्	म न ् त ् र ि त व ा न ् |
मन्त्रित्वपद	म न ् त ् र ि त ् व प द |
मन्त्रित्वेन	म न ् त ् र ि त ् व े न |
मन्त्रिपद	म न ् त ् र ि प द |
मन्त्रिपदप्रत्याशिनो	म न ् त ् र ि प द प ् र त ् य ा श ि न ो |
मन्त्रिपदारूढा	म न ् त ् र ि प द ा र ू ढ ा |
मन्त्रिवर्या	म न ् त ् र ि व र ् य ा |
मन्त्री	म न ् त ् र ी |
मन्त्रे	म न ् त ् र े |
मन्त्रेण	म न ् त ् र े ण |
मन्त्रेणं	म न ् त ् र े ण ं |
मन्त्रेषु	म न ् त ् र े ष ु |
मन्त्रेष्वेव	म न ् त ् र े ष ् व े व |
मन्द	म न ् द |
मन्यन्ते	म न ् य न ् त े |
मन्वादयः	म न ् व ा द य ः |
मन्वादिभिः	म न ् व ा द ि भ ि ः |
मन्वादीनां	म न ् व ा द ी न ा ं |
मम	म म |
ममसंशयास्सन्ति	म म स ं श य ा स ् स न ् त ि |
मया	म य ा |
मर्कटः	म र ् क ट ः |
मर्णानां	म र ् ण ा न ा ं |
मलय	म ल य |
मलालायूसुफ़्ज़ईइतिवीरकिशोर्या	म ल ा ल ा य ू स ु फ ़ ् ज ़ ई इ त ि व ी र क ि श ो र ् य ा |
मलिर्कारागारे	म ल ि र ् क ा र ा ग ा र े |
मलेशियादेशः	म ल े श ि य ा द े श ः |
मलेशियादेशेन	म ल े श ि य ा द े श े न |
मल्लिकार्जुनखड्गे	म ल ् ल ि क ा र ् ज ु न ख ड ् ग े |
मसईपेट्ग्रामस्य	म स ई प े ट ् ग ् र ा म स ् य |
मस्तिष्क	म स ् त ि ष ् क |
मह	म ह |
महता	म ह त ा |
महत्तरदायित्वं	म ह त ् त र द ा य ि त ् व ं |
महत्त्वाधायिनीम्	म ह त ् त ् व ा ध ा य ि न ी म ् |
महत्वं	म ह त ् व ं |
महत्वाधायि	म ह त ् व ा ध ा य ि |
महा	म ह ा |
महाकुम्भे	म ह ा क ु म ् भ े |
महाजमनः	म ह ा ज म न ः |
महात्म	म ह ा त ् म |
महात्मामन्दिरे	म ह ा त ् म ा म न ् द ि र े |
महानद्यां	म ह ा न द ् य ा ं |
महानद्याः	म ह ा न द ् य ा ः |
महानसीयवाति	म ह ा न स ी य व ा त ि |
महानसीयेन्ध्रनक्रयणाय	म ह ा न स ी य े न ् ध ् र न क ् र य ण ा य |
महान्तमुपकारम	म ह ा न ् त म ु प क ा र म |
महाभागः	म ह ा भ ा ग ः |
महाभागया	म ह ा भ ा ग य ा |
महाभागां	म ह ा भ ा ग ा ं |
महाभागाय	म ह ा भ ा ग ा य |
महाभारत	म ह ा भ ा र त |
महाभारते	म ह ा भ ा र त े |
महायव्यय	म ह ा य व ् य य |
महाराजः	म ह ा र ा ज ः |
महाराष्ट्र	म ह ा र ा ष ् ट ् र |
महाराष्ट्रे	म ह ा र ा ष ् ट ् र े |
महासनीयवात्यै	म ह ा स न ी य व ा त ् य ै |
महिला	म ह ि ल ा |
महिलाः	म ह ि ल ा ः |
महिलाकल्याणार्थम्	म ह ि ल ा क ल ् य ा ण ा र ् थ म ् |
महिषः	म ह ि ष ः |
महेन्द्रगढे	म ह े न ् द ् र ग ढ े |
महेश्वरः	म ह े श ् व र ः |
महोत्सवे	म ह ो त ् स व े |
महोदयेन	म ह ो द य े न |
मा	म ा |
माता	म ा त ा |
मात्र	म ा त ् र |
माधवीयध्	म ा ध व ी य ध ् |
माध्यमिकां	म ा ध ् य म ि क ा ं |
माध्यस्थविषयकं	म ा ध ् य स ् थ व ि ष य क ं |
माध्यस्थार्थं	म ा ध ् य स ् थ ा र ् थ ं |
मानव	म ा न व |
मानवसंसाधनविकास	म ा न व स ं स ा ध न व ि क ा स |
मायारूपं	म ा य ा र ू प ं |
माराठा	म ा र ा ठ ा |
मारितः	म ा र ि त ः |
मारितवन्तः	म ा र ि त व न ् त ः |
मारिया	म ा र ि य ा |
मारिषम्	म ा र ि ष म ् |
मार्कज्विब्लरं	म ा र ् क ज ् व ि ब ् ल र ं |
मार्गीय	म ा र ् ग ी य |
मार्गीयदुर्घटनायां	म ा र ् ग ी य द ु र ् घ ट न ा य ा ं |
मार्गीयनिर्वाचनसभायोजनार्थं	म ा र ् ग ी य न ि र ् व ा च न स भ ा य ो ज न ा र ् थ ं |
मार्गे	म ा र ् ग े |
मालिकाया	म ा ल ि क ा य ा |
मालिकायां	म ा ल ि क ा य ा ं |
मालिकायाः	म ा ल ि क ा य ा ः |
मालिनग्रामे	म ा ल ि न ग ् र ा म े |
मास	म ा स |
मासः	म ा स ः |
मासत्रयात्	म ा स त ् र य ा त ् |
मासस्य	म ा स स ् य |
मासि	म ा स ि |
मासिश्राद्ध	म ा स ि श ् र ा द ् ध |
मासिश्राद्धस्य	म ा स ि श ् र ा द ् ध स ् य |
मासे	म ा स े |
मासेषु	म ा स े ष ु |
मासेस्मिन्	म ा स े स ् म ि न ् |
मिज़ोरमराज्यपालपदात्	म ि ज ़ ो र म र ा ज ् य प ा ल प द ा त ् |
मिज़ोरां	म ि ज ़ ो र ा ं |
मित्राक्रमणं	म ि त ् र ा क ् र म ण ं |
मिलितवान्	म ि ल ि त व ा न ् |
मिलित्वा	म ि ल ि त ् व ा |
मिश्र	म ि श ् र |
मीमांसक	म ी म ा ं स क |
मीमांसकाः	म ी म ा ं स क ा ः |
मीमांसा	म ी म ा ं स ा |
मीरपुरे	म ी र प ु र े |
मुक्तविपण्यां	म ु क ् त व ि प ण ् य ा ं |
मुखर्जिन	म ु ख र ् ज ि न |
मुखर्जी	म ु ख र ् ज ी |
मुखर्जीः	म ु ख र ् ज ी ः |
मुख्य	म ु ख ् य |
मुख्यअवधानतायुक्तस्य	म ु ख ् य अ व ध ा न त ा य ु क ् त स ् य |
मुख्यालयेषु	म ु ख ् य ा ल य े ष ु |
मुण्डकवाक्यम्	म ु ण ् ड क व ा क ् य म ् |
मुण्डे	म ु ण ् ड े |
मुण्डोच्छेदस्य	म ु ण ् ड ो च ् छ े द स ् य |
मुद्गल	म ु द ् ग ल |
मुद्रास्फ़ीतिमितिः	म ु द ् र ा स ् फ ़ ी त ि म ि त ि ः |
मुद्रास्फ़ीतेः	म ु द ् र ा स ् फ ़ ी त े ः |
मुधानामपत्रसंकेत्यादिकं	म ु ध ा न ा म प त ् र स ं क े त ् य ा द ि क ं |
मुनेः	म ु न े ः |
मुप्तप्रायः	म ु प ् त प ् र ा य ः |
मुम्बईइण्डियन्स्वृन्देन	म ु म ् ब ई इ ण ् ड ि य न ् स ् व ृ न ् द े न |
मुम्बय्यां	म ु म ् ब य ् य ा ं |
मुशरफ़स्य	म ु श र फ ़ स ् य |
मुष्टीमुष्टि	म ु ष ् ट ी म ु ष ् ट ि |
मुसलामुसलि	म ु स ल ा म ु स ल ि |
मुस्लिमानां	म ु स ् ल ि म ा न ा ं |
मुस्लिमोपदेशकः	म ु स ् ल ि म ो प द े श क ः |
मूर्धन्य	म ू र ् ध न ् य |
मूल	म ू ल |
मूल्य	म ू ल ् य |
मूल्यं	म ू ल ् य ं |
मूल्यपरिष्कारो	म ू ल ् य प र ि ष ् क ा र ो |
मूल्यम्	म ू ल ् य म ् |
मूल्यस्थिरीकरणकोषसंस्थापनं	म ू ल ् य स ् थ ि र ी क र ण क ो ष स ं स ् थ ा प न ं |
मूल्यानि	म ू ल ् य ा न ि |
मूल्येषु	म ू ल ् य े ष ु |
मृगेषु	म ृ ग े ष ु |
मृत	म ृ त |
मृतकपरिवारान्	म ृ त क प र ि व ा र ा न ् |
मृतकपरिवारेभ्यः	म ृ त क प र ि व ा र े भ ् य ः |
मृताः	म ृ त ा ः |
मृतानां	म ृ त ा न ा ं |
मृत्युमुपगतानां	म ृ त ् य ु म ु प ग त ा न ा ं |
मृत्युम्	म ृ त ् य ु म ् |
मेडकजनपदे	म े ड क ज न प द े |
मेदिनीग्रन्थे	म े द ि न ी ग ् र न ् थ े |
मेरठ	म े र ठ |
मेलिष्यति	म े ल ि ष ् य त ि |
मोघीकृतः	म ो घ ी क ृ त ः |
मोचनम्	म ो च न म ् |
मोदिद्वारा	म ो द ि द ् व ा र ा |
मोदिनं	म ो द ि न ं |
मोदिनः	म ो द ि न ः |
मोदिना	म ो द ि न ा |
मोदिप्रशासनम्	म ो द ि प ् र श ा स न म ् |
मोदिप्रशासनस्य	म ो द ि प ् र श ा स न स ् य |
मोदी	म ो द ी |
मोमपानीटाइडिंगस्थानयोः	म ो म प ा न ी ट ा इ ड ि ं ग स ् थ ा न य ो ः |
मोशेयालोनमहोदयं	म ो श े य ा ल ो न म ह ो द य ं |
मोहन	म ो ह न |
मौद्रिकानुदानम्	म ौ द ् र ि क ा न ु द ा न म ् |
मौलानाफ़ज़लुररहमानम्	म ौ ल ा न ा फ ़ ज ़ ल ु र र ह म ा न म ् |
म्यांमारओस्ट्रेलियाफिजीचेति	म ् य ा ं म ा र ओ स ् ट ् र े ल ि य ा फ ि ज ी च े त ि |
म्यांमारदेशं	म ् य ा ं म ा र द े श ं |
य	य |
यकश्वन	य क श ् व न |
यजमधीयानाः	य ज म ध ी य ा न ा ः |
यजमयत्वेन	य ज म य त ् व े न |
यजमानः	य ज म ा न ः |
यजसुष्टिसंवन्धः	य ज स ु ष ् ट ि स ं व न ् ध ः |
यजुर्वेदस्य	य ज ु र ् व े द स ् य |
यजेत	य ज े त |
यज्	य ज ् |
यज्जायते	य ज ् ज ा य त े |
यज्जुहोषि	य ज ् ज ु ह ो ष ि |
यज्ञ	य ज ् ञ |
यज्ञं	य ज ् ञ ं |
यज्ञः	य ज ् ञ ः |
यज्ञत्वं	य ज ् ञ त ् व ं |
यज्ञत्वेन	य ज ् ञ त ् व े न |
यज्ञध्ययनां	य ज ् ञ ध ् य य न ा ं |
यज्ञपदार्थः	य ज ् ञ प द ा र ् थ ः |
यज्ञप्रयोगः	य ज ् ञ प ् र य ो ग ः |
यज्ञप्रयोजनं	य ज ् ञ प ् र य ो ज न ं |
यज्ञप्रयोजनमुक्त्वा	य ज ् ञ प ् र य ो ज न म ु क ् त ् व ा |
यज्ञप्रयोजनम्	य ज ् ञ प ् र य ो ज न म ् |
यज्ञभेदाः	य ज ् ञ भ े द ा ः |
यज्ञमधीयानाः	य ज ् ञ म ध ी य ा न ा ः |
यज्ञमयत्वेन	य ज ् ञ म य त ् व े न |
यज्ञरूपेणैव	य ज ् ञ र ू प े ण ै व |
यज्ञविभागाः	य ज ् ञ व ि भ ा ग ा ः |
यज्ञशब्दार्थः	य ज ् ञ श ब ् द ा र ् थ ः |
यज्ञशब्दार्थे	य ज ् ञ श ब ् द ा र ् थ े |
यज्ञशब्दार्थ्ः	य ज ् ञ श ब ् द ा र ् थ ् ः |
यज्ञशब्देन	य ज ् ञ श ब ् द े न |
यज्ञशास्त्रं	य ज ् ञ श ा स ् त ् र ं |
यज्ञसाधनानि	य ज ् ञ स ा ध न ा न ि |
यज्ञसृष्ट्योस्सम्बन्धः	य ज ् ञ स ृ ष ् ट ् य ो स ् स म ् ब न ् ध ः |
यज्ञस्य	य ज ् ञ स ् य |
यज्ञस्वरूपं	य ज ् ञ स ् व र ू प ं |
यज्ञस्वरूपार्थविषये	य ज ् ञ स ् व र ू प ा र ् थ व ि ष य े |
यज्ञाः	य ज ् ञ ा ः |
यज्ञाद्यनुष्ठातुं	य ज ् ञ ा द ् य न ु ष ् ठ ा त ु ं |
यज्ञाध्ययं	य ज ् ञ ा ध ् य य ं |
यज्ञाध्ययनं	य ज ् ञ ा ध ् य य न ं |
यज्ञाध्ययनमपि	य ज ् ञ ा ध ् य य न म प ि |
यज्ञाध्ययनस्य	य ज ् ञ ा ध ् य य न स ् य |
यज्ञानुष्ठान	य ज ् ञ ा न ु ष ् ठ ा न |
यज्ञानुष्ठानं	य ज ् ञ ा न ु ष ् ठ ा न ं |
यज्ञानुष्ठानञ्च	य ज ् ञ ा न ु ष ् ठ ा न ञ ् च |
यज्ञानुष्ठानप्राकारस्य	य ज ् ञ ा न ु ष ् ठ ा न प ् र ा क ा र स ् य |
यज्ञानुष्ठानमपि	य ज ् ञ ा न ु ष ् ठ ा न म प ि |
यज्ञाय	य ज ् ञ ा य |
यज्ञायज्ञियेषु	य ज ् ञ ा य ज ् ञ ि य े ष ु |
यज्ञार्थात्	य ज ् ञ ा र ् थ ा त ् |
यज्ञार्थो	य ज ् ञ ा र ् थ ो |
यज्ञाशब्दार्थः	य ज ् ञ ा श ब ् द ा र ् थ ः |
यज्ञिया	य ज ् ञ ि य ा |
यज्ञियेतनु	य ज ् ञ ि य े त न ु |
यज्ञे	य ज ् ञ े |
यज्ञेन	य ज ् ञ े न |
यज्ञेशब्देन	य ज ् ञ े श ब ् द े न |
यज्ञेषु	य ज ् ञ े ष ु |
यज्ञो	य ज ् ञ ो |
यज्ञोपवीतानि	य ज ् ञ ो प व ी त ा न ि |
यज्ञोपवीतिना	य ज ् ञ ो प व ी त ि न ा |
यज्ञौ	य ज ् ञ ौ |
यत	य त |
यतः	य त ः |
यतप्रवृत्तिर्भूतानां	य त प ् र व ृ त ् त ि र ् भ ू त ा न ा ं |
यतो	य त ो |
यत्	य त ् |
यत्करोषि	य त ् क र ो ष ि |
यत्किञ्चित्	य त ् क ि ञ ् च ि त ् |
यत्किञ्चिद्वा	य त ् क ि ञ ् च ि द ् व ा |
यत्किञ्चिय्	य त ् क ि ञ ् च ि य ् |
यत्चिञ्चित्	य त ् च ि ञ ् च ि त ् |
यत्तपस्यसि	य त ् त प स ् य स ि |
यत्तपस्यसीति	य त ् त प स ् य स ी त ि |
यत्र	य त ् र |
यत्रपूर्णतयाविहितानि	य त ् र प ू र ् ण त य ा व ि ह ि त ा न ि |
यथा	य थ ा |
यथाकथञ्चित्	य थ ा क थ ञ ् च ि त ् |
यथावत्	य थ ा व त ् |
यथावद्	य थ ा व द ् |
यदश्नासि	य द श ् न ा स ि |
यदसौ	य द स ौ |
यदा	य द ा |
यदाग्नेयौष्टाकपालौ	य द ा ग ् न े य ौ ष ् ट ा क प ा ल ौ |
यदि	य द ि |
यदुच्यते	य द ु च ् य त े |
यदैषमो	य द ै ष म ो |
यद्देशस्य	य द ् द े श स ् य |
यद्यपि	य द ् य प ि |
यन्नेतृ	य न ् न े त ृ |
यस्मिन्	य स ् म ि न ् |
यस्य	य स ् य |
यस्यां	य स ् य ा ं |
यस्स	य स ् स |
या	य ा |
याकाचित्	य ा क ा च ि त ् |
यागं	य ा ग ं |
यागः	य ा ग ः |
यागमपि	य ा ग म प ि |
याचिका	य ा च ि क ा |
याचिकां	य ा च ि क ा ं |
याजं	य ा ज ं |
याजिकी	य ा ज ि क ी |
याज्ञवल्क्य	य ा ज ् ञ व ल ् क ् य |
याति	य ा त ि |
यात्रा	य ा त ् र ा |
यात्रां	य ा त ् र ा ं |
यात्रायाः	य ा त ् र ा य ा ः |
यात्रि	य ा त ् र ि |
यात्रिणः	य ा त ् र ि ण ः |
यात्रिणो	य ा त ् र ि ण ो |
यादवेन	य ा द व े न |
यानं	य ा न ं |
यानदुर्घटनायाः	य ा न द ु र ् घ ट न ा य ा ः |
यानमेतत्	य ा न म े त त ् |
यानम्	य ा न म ् |
यानस्य	य ा न स ् य |
यानि	य ा न ि |
यानेन	य ा न े न |
यान्यपश्यन्	य ा न ् य प श ् य न ् |
यावज्जीवं	य ा व ज ् ज ी व ं |
यावत्	य ा व त ् |
युक्तं	य ु क ् त ं |
युक्तः	य ु क ् त ः |
युक्तो	य ु क ् त ो |
युक्त्वा	य ु क ् त ् व ा |
युगप्रवर्तनाय	य ु ग प ् र व र ् त न ा य |
युगारम्भो	य ु ग ा र म ् भ ो |
युद्धं	य ु द ् ध ं |
युद्धे	य ु द ् ध े |
यू	य ू |
ये	य े |
येतानि	य े त ा न ि |
येते	य े त े |
येनकेनापि	य े न क े न ा प ि |
येनसर्वमिदं	य े न स र ् व म ि द ं |
यो	य ो |
योगदिवसायोजनम्	य ो ग द ि व स ा य ो ज न म ् |
योगस्य	य ो ग स ् य |
योजनस्य	य ो ज न स ् य |
योजनाः	य ो ज न ा ः |
योजनायोगस्य	य ो ज न ा य ो ग स ् य |
योद्धृ	य ो द ् ध ृ |
योधाः	य ो ध ा ः |
योयं	य ो य ं |
रक्षण	र क ् ष ण |
रक्षणार्थं	र क ् ष ण ा र ् थ ं |
रक्षामन्त्रिणं	र क ् ष ा म न ् त ् र ि ण ं |
रक्षि	र क ् ष ि |
रक्षिकार्मिकान्	र क ् ष ि क ा र ् म ि क ा न ् |
रक्षित्रयं	र क ् ष ि त ् र य ं |
रक्षिबलस्य	र क ् ष ि ब ल स ् य |
रचनायाश्च	र च न ा य ा श ् च |
रचनायै	र च न ा य ै |
रचनेन	र च न े न |
रचयितुं	र च य ि त ु ं |
रजत	र ज त |
रजतपदकानि	र ज त प द क ा न ि |
रथोत्सवः	र थ ो त ् स व ः |
रम्ज़ान	र म ् ज ़ ा न |
रवि	र व ि |
रशियाराष्ट्रपतिना	र श ि य ा र ा ष ् ट ् र प त ि न ा |
रसात्मकः	र स ा त ् म क ः |
रांचीनगरे	र ा ं च ी न ग र े |
राक्षसानां	र ा क ् ष स ा न ा ं |
राजतानि	र ा ज त ा न ि |
राजदूतः	र ा ज द ू त ः |
राजनाथ	र ा ज न ा थ |
राजनाथसिंहः	र ा ज न ा थ स ि ं ह ः |
राजनाथसिंहेन	र ा ज न ा थ स ि ं ह े न |
राजनीतिक	र ा ज न ी त ि क |
राजनीतिकदलानां	र ा ज न ी त ि क द ल ा न ा ं |
राजनीतिकदलेभ्यो	र ा ज न ी त ि क द ल े भ ् य ो |
राजनीतिकस्थैर्यस्य	र ा ज न ी त ि क स ् थ ै र ् य स ् य |
राजनीतिका	र ा ज न ी त ि क ा |
राजनीतिकीकरणं	र ा ज न ी त ि क ी क र ण ं |
राजनीतिज्ञाश्च	र ा ज न ी त ि ज ् ञ ा श ् च |
राजनीतितः	र ा ज न ी त ि त ः |
राजनीतिम्	र ा ज न ी त ि म ् |
राजमार्गे	र ा ज म ा र ् ग े |
राजसूय	र ा ज स ू य |
राजस्थान	र ा ज स ् थ ा न |
राजस्थानरोयल्स्दलं	र ा ज स ् थ ा न र ो य ल ् स ् द ल ं |
राजस्व	र ा ज स ् व |
राजे	र ा ज े |
राज्ञः	र ा ज ् ञ ः |
राज्य	र ा ज ् य |
राज्यपाल	र ा ज ् य प ा ल |
राज्यपालत्वेन	र ा ज ् य प ा ल त ् व े न |
राज्यपालम्	र ा ज ् य प ा ल म ् |
राज्यपालस्य	र ा ज ् य प ा ल स ् य |
राज्यपालानां	र ा ज ् य प ा ल ा न ा ं |
राज्यपालाय	र ा ज ् य प ा ल ा य |
राज्यसभा	र ा ज ् य स भ ा |
राज्यसभायां	र ा ज ् य स भ ा य ा ं |
राज्यसभायाः	र ा ज ् य स भ ा य ा ः |
राज्यसभासनानां	र ा ज ् य स भ ा स न ा न ा ं |
राज्यस्य	र ा ज ् य स ् य |
राज्यानां	र ा ज ् य ा न ा ं |
राज्ये	र ा ज ् य े |
राज्येषु	र ा ज ् य े ष ु |
राज्यैश्च	र ा ज ् य ै श ् च |
राठौरेण	र ा ठ ौ र े ण |
रात्रि	र ा त ् र ि |
रात्रितः	र ा त ् र ि त ः |
रात्रौ	र ा त ् र ौ |
राधा	र ा ध ा |
राफेलनडालः	र ा फ े ल न ड ा ल ः |
राम	र ा म |
रामनाइकः	र ा म न ा इ क ः |
रायः	र ा य ः |
रायगढ	र ा य ग ढ |
राशिः	र ा श ि ः |
राष्ट्र	र ा ष ् ट ् र |
राष्ट्रपतये	र ा ष ् ट ् र प त य े |
राष्ट्रपति	र ा ष ् ट ् र प त ि |
राष्ट्रपतिं	र ा ष ् ट ् र प त ि ं |
राष्ट्रपतिः	र ा ष ् ट ् र प त ि ः |
राष्ट्रपतिन	र ा ष ् ट ् र प त ि न |
राष्ट्रपतिना	र ा ष ् ट ् र प त ि न ा |
राष्ट्रपतिमहाभागाय	र ा ष ् ट ् र प त ि म ह ा भ ा ग ा य |
राष्ट्रपतिशासनं	र ा ष ् ट ् र प त ि श ा स न ं |
राष्ट्रपतिशासनम्	र ा ष ् ट ् र प त ि श ा स न म ् |
राष्ट्रमद्य	र ा ष ् ट ् र म द ् य |
राष्ट्रम्	र ा ष ् ट ् र म ् |
राष्ट्रस्य	र ा ष ् ट ् र स ् य |
राष्ट्राध्यक्षया	र ा ष ् ट ् र ा ध ् य क ् ष य ा |
राष्ट्राध्यक्षायाः	र ा ष ् ट ् र ा ध ् य क ् ष ा य ा ः |
राष्ट्रिय	र ा ष ् ट ् र ि य |
राष्ट्रियराजधान्यां	र ा ष ् ट ् र ि य र ा ज ध ा न ् य ा ं |
राष्ट्रियलोक	र ा ष ् ट ् र ि य ल ो क |
राष्ट्रियविपणन	र ा ष ् ट ् र ि य व ि प ण न |
राष्ट्रियसुरक्षापरामर्शदेन	र ा ष ् ट ् र ि य स ु र क ् ष ा प र ा म र ् श द े न |
राष्ट्रियान्वीक्षणाभिकरणस्य	र ा ष ् ट ् र ि य ा न ् व ी क ् ष ण ा भ ि क र ण स ् य |
राष्ट्रियापत्	र ा ष ् ट ् र ि य ा प त ् |
राहुल्	र ा ह ु ल ् |
रुष्टा	र ु ष ् ट ा |
रूढः	र ू ढ ः |
रूप	र ू प |
रूपत्वेन	र ू प त ् व े न |
रूपिणी	र ू प ि ण ी |
रूपेण	र ू प े ण |
रूपेषु	र ू प े ष ु |
रूप्यकमूल्यवतां	र ू प ् य क म ू ल ् य व त ा ं |
रूप्यकाणां	र ू प ् य क ा ण ा ं |
रूप्यकाणि	र ू प ् य क ा ण ि |
रूप्यकात्मक्	र ू प ् य क ा त ् म क ् |
रूप्यकात्ममं	र ू प ् य क ा त ् म म ं |
रूप्यकैः	र ू प ् य क ै ः |
रेखा	र े ख ा |
रेखायां	र े ख ा य ा ं |
रेल	र े ल |
रेल्मन्त्री	र े ल ् म न ् त ् र ी |
रेल्विभागीयसुरक्षायुक्तेन	र े ल ् व ि भ ा ग ी य स ु र क ् ष ा य ु क ् त े न |
रेल्विभागो	र े ल ् व ि भ ा ग ो |
रॉयल्चैलेन्जर्स्बेंगलूरुदलं	र ॉ य ल ् च ै ल े न ् ज र ् स ् ब े ं ग ल ू र ु द ल ं |
रोमाञ्च	र ो म ा ञ ् च |
रोमानियादेशीयां	र ो म ा न ि य ा द े श ी य ा ं |
रोयल्चैलेन्जर्स्क्रीडकैः	र ो य ल ् च ै ल े न ् ज र ् स ् क ् र ी ड क ै ः |
रौक्ष्ण्यं	र ौ क ् ष ् ण ् य ं |
र्वियुक्ताः	र ् व ि य ु क ् त ा ः |
लक्ष	ल क ् ष |
लक्षण	ल क ् ष ण |
लक्षणय	ल क ् ष ण य |
लक्षभारतीयनागरिकाः	ल क ् ष भ ा र त ी य न ा ग र ि क ा ः |
लक्षमितो	ल क ् ष म ि त ो |
लक्षरूप्यकेभ्यो	ल क ् ष र ू प ् य क े भ ् य ो |
लक्षाधिकाः	ल क ् ष ा ध ि क ा ः |
लक्ष्य	ल क ् ष ् य |
लक्ष्यीकृत्य	ल क ् ष ् य ी क ृ त ् य |
लक्ष्ये	ल क ् ष ् य े |
लखीपुरासनाय	ल ख ी प ु र ा स न ा य |
लखीम्पुर्खिरीसीतापुर्श्रावस्तीबलरामपुर्गोण्डाजनपदानां	ल ख ी म ् प ु र ् ख ि र ी स ी त ा प ु र ् श ् र ा व स ् त ी ब ल र ा म प ु र ् ग ो ण ् ड ा ज न प द ा न ा ं |
लघु	ल घ ु |
लद्दाख	ल द ् द ा ख |
लभ्यते	ल भ ् य त े |
लश्करएतैयबासंघटनस्य	ल श ् क र ए त ै य ब ा स ं घ ट न स ् य |
लश्कर्इतोयबासंघटनस्य	ल श ् क र ् इ त ो य ब ा स ं घ ट न स ् य |
लातेहार्	ल ा त े ह ा र ् |
लाभानां	ल ा भ ा न ा ं |
लाल	ल ा ल |
लाल्नेहरोः	ल ा ल ् न े ह र ो ः |
लिखितं	ल ि ख ि त ं |
लिङ्ग	ल ि ङ ् ग |
लियूशिनं	ल ि य ू श ि न ं |
लीबिया	ल ी ब ि य ा |
लेखनीः	ल े ख न ी ः |
लेखा	ल े ख ा |
लैकिकं	ल ै क ि क ं |
लोक	ल ो क |
लोकसभा	ल ो क स भ ा |
लोकसभाध्यक्षः	ल ो क स भ ा ध ् य क ् ष ः |
लोकसभाध्यक्षपदार्थं	ल ो क स भ ा ध ् य क ् ष प द ा र ् थ ं |
लोकसभाध्यक्षया	ल ो क स भ ा ध ् य क ् ष य ा |
लोकसभाध्यक्षा	ल ो क स भ ा ध ् य क ् ष ा |
लोकसभाध्यक्षां	ल ो क स भ ा ध ् य क ् ष ा ं |
लोकसभानिर्वाचनकालेषु	ल ो क स भ ा न ि र ् व ा च न क ा ल े ष ु |
लोकसभानिर्वाचनानां	ल ो क स भ ा न ि र ् व ा च न ा न ा ं |
लोकसभानिर्वाचनानाम्	ल ो क स भ ा न ि र ् व ा च न ा न ा म ् |
लोकसभानिर्वाचनेषु	ल ो क स भ ा न ि र ् व ा च न े ष ु |
लोकसभामहानिर्वाचनानां	ल ो क स भ ा म ह ा न ि र ् व ा च न ा न ा ं |
लोकसभामहानिर्वाचनानि	ल ो क स भ ा म ह ा न ि र ् व ा च न ा न ि |
लोकसभायां	ल ो क स भ ा य ा ं |
लोकसभायाः	ल ो क स भ ा य ा ः |
लोकसभायाम्	ल ो क स भ ा य ा म ् |
लोकसभासनानाम्	ल ो क स भ ा स न ा न ा म ् |
लोका	ल ो क ा |
लोकाः	ल ो क ा ः |
लोकानुजिघृक्षया	ल ो क ा न ु ज ि घ ृ क ् ष य ा |
लोके	ल ो क े |
लोकेपि	ल ो क े प ि |
लोकेभ्यः	ल ो क े भ ् य ः |
लौकिकं	ल ौ क ि क ं |
लौकिकस्संपद्यते	ल ौ क ि क स ् स ं प द ् य त े |
व	व |
वः	व ः |
वक्तव्यं	व क ् त व ् य ं |
वक्तव्यमभिलक्ष्य	व क ् त व ् य म भ ि ल क ् ष ् य |
वक्ष्यन्ति	व क ् ष ् य न ् त ि |
वक्ष्यमाणान्	व क ् ष ् य म ा ण ा न ् |
वचन	व च न |
वचनमपि	व च न म प ि |
वचनम्	व च न म ् |
वचनाच्च	व च न ा च ् च |
वचनानि	व च न ा न ि |
वचनान्	व च न ा न ् |
वत्सार्थम्	व त ् स ा र ् थ म ् |
वदन्	व द न ् |
वदन्ति	व द न ् त ि |
वदन्नस्ति	व द न ् न स ् त ि |
वनराजः	व न र ा ज ः |
वन्पोह्ग्रामे	व न ् प ो ह ् ग ् र ा म े |
वन्य	व न ् य |
वयं	व य ं |
वरति	व र त ि |
वराणस्यां	व र ा ण स ् य ा ं |
वरिष्ठः	व र ि ष ् ठ ः |
वरिष्ठनागरिकेभ्यः	व र ि ष ् ठ न ा ग र ि क े भ ् य ः |
वरिष्ठरक्ष्यधीक्षकः	व र ि ष ् ठ र क ् ष ् य ध ी क ् ष क ः |
वरिष्ठा	व र ि ष ् ठ ा |
वरिष्ठाधिकारिणो	व र ि ष ् ठ ा ध ि क ा र ि ण ो |
वरिष्ठान्	व र ि ष ् ठ ा न ् |
वरिष्ठायाः	व र ि ष ् ठ ा य ा ः |
वरिष्ठैः	व र ि ष ् ठ ै ः |
वरिष्ठो	व र ि ष ् ठ ो |
वर्गस्य	व र ् ग स ् य |
वर्गाणि	व र ् ग ा ण ि |
वर्गीयचरमपन्थिनां	व र ् ग ी य च र म प न ् थ ि न ा ं |
वर्गीयद्वन्द्वे	व र ् ग ी य द ् व न ् द ् व े |
वर्गीयाणां	व र ् ग ी य ा ण ा ं |
वर्गे	व र ् ग े |
वर्गेण	व र ् ग े ण |
वर्णितम्	व र ् ण ि त म ् |
वर्णिता	व र ् ण ि त ा |
वर्तते	व र ् त त े |
वर्तन्ते	व र ् त न ् त े |
वर्तमान	व र ् त म ा न |
वर्तमानस्य	व र ् त म ा न स ् य |
वर्तमानानांसम्बन्धानां	व र ् त म ा न ा न ा ं स म ् ब न ् ध ा न ा ं |
वर्तमानानि	व र ् त म ा न ा न ि |
वर्तमानैः	व र ् त म ा न ै ः |
वर्तित	व र ् त ि त |
वर्धकेन	व र ् ध क े न |
वर्धमानां	व र ् ध म ा न ा ं |
वर्धापयन्	व र ् ध ा प य न ् |
वर्धापितः	व र ् ध ा प ि त ः |
वर्धापितवती	व र ् ध ा प ि त व त ी |
वर्धापितवान्	व र ् ध ा प ि त व ा न ् |
वर्यं	व र ् य ं |
वर्यस्य	व र ् य स ् य |
वर्यायाः	व र ् य ा य ा ः |
वर्येण	व र ् य े ण |
वर्षतो	व र ् ष त ो |
वर्षदेशीयेन	व र ् ष द े श ी य े न |
वर्षाणि	व र ् ष ा ण ि |
वर्षार्थं	व र ् ष ा र ् थ ं |
वर्षावधये	व र ् ष ा व ध य े |
वर्षीयं	व र ् ष ी य ं |
वर्षीयरेलार्थसंकल्पस्य	व र ् ष ी य र े ल ा र ् थ स ं क ल ् प स ् य |
वर्षीया	व र ् ष ी य ा |
वर्षीये	व र ् ष ी य े |
वर्षे	व र ् ष े |
वर्षेभ्य	व र ् ष े भ ् य |
वसन्ते	व स न ् त े |
वसुन्धरा	व स ु न ् ध र ा |
वस्तु	व स ् त ु |
वस्तूनि	व स ् त ू न ि |
वस्त्रम्	व स ् त ् र म ् |
वहति	व ह त ि |
वा	व ा |
वांगयिः	व ा ं ग य ि ः |
वांग्यिः	व ा ं ग ् य ि ः |
वाऋषिर्वा	व ा ऋ ष ि र ् व ा |
वाक्कलहेन	व ा क ् क ल ह े न |
वाक्यम्	व ा क ् य म ् |
वाक्यानां	व ा क ् य ा न ा ं |
वाक्येषु	व ा क ् य े ष ु |
वाच्याः	व ा च ् य ा ः |
वाच्यानि	व ा च ् य ा न ि |
वाजपेयः	व ा ज प े य ः |
वाञ्छति	व ा ञ ् छ त ि |
वाञ्छन्ति	व ा ञ ् छ न ् त ि |
वातेः	व ा त े ः |
वादनं	व ा द न ं |
वादश्रवणम्	व ा द श ् र व ण म ् |
वानरैः	व ा न र ै ः |
वाम	व ा म |
वामपंथ्	व ा म प ं थ ् |
वायु	व ा य ु |
वारं	व ा र ं |
वारमेव	व ा र म े व |
वाराणस्यां	व ा र ा ण स ् य ा ं |
वाराणस्यामायोज्यमानेषु	व ा र ा ण स ् य ा म ा य ो ज ् य म ा न े ष ु |
वार्ता	व ा र ् त ा |
वार्ताहर	व ा र ् त ा ह र |
वार्ताहरसम्मेलनं	व ा र ् त ा ह र स म ् म े ल न ं |
वार्ताहरसम्मेलनमेकं	व ा र ् त ा ह र स म ् म े ल न म े क ं |
वार्ताहराणं	व ा र ् त ा ह र ा ण ं |
वार्ताहरान्	व ा र ् त ा ह र ा न ् |
वार्ताहरैः	व ा र ् त ा ह र ै ः |
वार्ताहरो	व ा र ् त ा ह र ो |
वासरे	व ा स र े |
वासीयाः	व ा स ी य ा ः |
वास्तविक्नियन्त्रण	व ा स ् त व ि क ् न ि य न ् त ् र ण |
वि	व ि |
विंशजि	व ि ं श ज ि |
विंशति	व ि ं श त ि |
विंशतिः	व ि ं श त ि ः |
विंशतिमितं	व ि ं श त ि म ि त ं |
विंशतिश्च	व ि ं श त ि श ् च |
विंशतिश्चाहताः	व ि ं श त ि श ् च ा ह त ा ः |
विंशाः	व ि ं श ा ः |
विंशे	व ि ं श े |
विः	व ि ः |
विएतनामदेशमन्त्	व ि ए त न ा म द े श म न ् त ् |
विएतनामदेशस्य	व ि ए त न ा म द े श स ् य |
विकल्पो	व ि क ल ् प ो |
विकार	व ि क ा र |
विकारस्य	व ि क ा र स ् य |
विकास	व ि क ा स |
विकासनीयाः	व ि क ा स न ी य ा ः |
विकासपर्यावरण्संरक्षणार्थं	व ि क ा स प र ् य ा व र ण ् स ं र क ् ष ण ा र ् थ ं |
विकासमितिः	व ि क ा स म ि त ि ः |
विकासस्य	व ि क ा स स ् य |
विकासाय	व ि क ा स ा य |
विकासितश्च	व ि क ा स ि त श ् च |
विकृतिपाठाः	व ि क ृ त ि प ा ठ ा ः |
विकृतियागाः	व ि क ृ त ि य ा ग ा ः |
विकृतिश्चेति	व ि क ृ त ि श ् च े त ि |
विखण्डितानि	व ि ख ण ् ड ि त ा न ि |
विख्यातस्य	व ि ख ् य ा त स ् य |
विगत	व ि ग त |
विगतमध्य	व ि ग त म ध ् य |
विघाटयितुं	व ि घ ा ट य ि त ु ं |
विघाटितानि	व ि घ ा ट ि त ा न ि |
विचारः	व ि च ा र ः |
विचारणा	व ि च ा र ण ा |
विचारणां	व ि च ा र ण ा ं |
विचारणाः	व ि च ा र ण ा ः |
विचारणाम्	व ि च ा र ण ा म ् |
विचारयति	व ि च ा र य त ि |
विचारयेत्	व ि च ा र य े त ् |
विचारविनिमयः	व ि च ा र व ि न ि म य ः |
विचारविमर्शः	व ि च ा र व ि म र ् श ः |
विचारविमर्शस्य	व ि च ा र व ि म र ् श स ् य |
विचाराः	व ि च ा र ा ः |
विचार्यविचार	व ि च ा र ् य व ि च ा र |
विच्यमाने	व ि च ् य म ा न े |
विजय	व ि ज य |
विजयं	व ि ज य ं |
विजययात्राणाम्	व ि ज य य ा त ् र ा ण ा म ् |
विजयश्रियम्	व ि ज य श ् र ि य म ् |
विजयश्रीः	व ि ज य श ् र ी ः |
विजयार्थं	व ि ज य ा र ् थ ं |
विजितमं	व ि ज ि त म ं |
विजितम्	व ि ज ि त म ् |
विजितवती	व ि ज ि त व त ी |
विजितवान्	व ि ज ि त व ा न ् |
विजिता	व ि ज ि त ा |
विजितानि	व ि ज ि त ा न ि |
विजित्य	व ि ज ि त ् य |
विजेतृ	व ि ज े त ृ |
विज्ञापयति	व ि ज ् ञ ा प य त ि |
विज्ञापितं	व ि ज ् ञ ा प ि त ं |
विज्ञायते	व ि ज ् ञ ा य त े |
वित्त	व ि त ् त |
वित्तमन्त्रिणं	व ि त ् त म न ् त ् र ि ण ं |
वित्तमन्त्रिणा	व ि त ् त म न ् त ् र ि ण ा |
वित्तमन्त्री	व ि त ् त म न ् त ् र ी |
वित्तवर्षीयाणां	व ि त ् त व र ् ष ी य ा ण ा ं |
वित्तीयसाहाय्यप्रदानार्थं	व ि त ् त ी य स ा ह ा य ् य प ् र द ा न ा र ् थ ं |
विदधाति	व ि द ध ा त ि |
विदितमेव	व ि द ि त म े व |
विदेश	व ि द े श |
विदेशमन्त्री	व ि द े श म न ् त ् र ी |
विदेशिव्यापार	व ि द े श ि व ् य ा प ा र |
विदेशे	व ि द े श े |
विद्यते	व ि द ् य त े |
विद्यतेति	व ि द ् य त े त ि |
विद्यन्ते	व ि द ् य न ् त े |
विद्यार्थी	व ि द ् य ा र ् थ ी |
विद्यालयस्य	व ि द ् य ा ल य स ् य |
विद्यालयानुदाना	व ि द ् य ा ल य ा न ु द ा न ा |
विद्यालयानुदानायोगस्य	व ि द ् य ा ल य ा न ु द ा न ा य ो ग स ् य |
विद्यालये	व ि द ् य ा ल य े |
विद्यालयैय	व ि द ् य ा ल य ै य |
विद्युतः	व ि द ् य ु त ः |
विद्युदापुर्तिः	व ि द ् य ु द ा प ु र ् त ि ः |
विद्वत्तल्लजः	व ि द ् व त ् त ल ् ल ज ः |
विद्वांसः	व ि द ् व ा ं स ः |
विद्वेषस्य	व ि द ् व े ष स ् य |
विधा	व ि ध ा |
विधातत्यः	व ि ध ा त त ् य ः |
विधातुं	व ि ध ा त ु ं |
विधातुम्	व ि ध ा त ु म ् |
विधान	व ि ध ा न |
विधानं	व ि ध ा न ं |
विधानसभा	व ि ध ा न स भ ा |
विधानसभायां	व ि ध ा न स भ ा य ा ं |
विधानसभासदस्यैः	व ि ध ा न स भ ा स द स ् य ै ः |
विधानसभासनानां	व ि ध ा न स भ ा स न ा न ा ं |
विधानसभासनार्थं	व ि ध ा न स भ ा स न ा र ् थ ं |
विधानसभोपनिर्वाचनार्थं	व ि ध ा न स भ ो प न ि र ् व ा च न ा र ् थ ं |
विधानात्	व ि ध ा न ा त ् |
विधानेन	व ि ध ा न े न |
विधानेनां	व ि ध ा न े न ा ं |
विधापयितुं	व ि ध ा प य ि त ु ं |
विधाय	व ि ध ा य |
विधायकदलं	व ि ध ा य क द ल ं |
विधायिकाकार्यपालिकायाभ्यां	व ि ध ा य ि क ा क ा र ् य प ा ल ि क ा य ा भ ् य ा ं |
विधास्यं	व ि ध ा स ् य ं |
विधास्यतः	व ि ध ा स ् य त ः |
विधास्यति	व ि ध ा स ् य त ि |
विधास्यते	व ि ध ा स ् य त े |
विधिः	व ि ध ि ः |
विधिदूरसंचार	व ि ध ि द ू र स ं च ा र |
विधीयते	व ि ध ी य त े |
विधीयन्ते	व ि ध ी य न ् त े |
विधीयमानस्य	व ि ध ी य म ा न स ् य |
विधीयमानाः	व ि ध ी य म ा न ा ः |
विधीयमानानि	व ि ध ी य म ा न ा न ि |
विधीयमानोअवैध	व ि ध ी य म ा न ो अ व ै ध |
विधेयकं	व ि ध े य क ं |
विध्यन्ति	व ि ध ् य न ् त ि |
विनम्रतया	व ि न म ् र त य ा |
विना	व ि न ा |
विनिर्धारित्	व ि न ि र ् ध ा र ि त ् |
विनिवेदिताः	व ि न ि व े द ि त ा ः |
विनिवेशं	व ि न ि व े श ं |
विनैव	व ि न ै व |
विपक्ष	व ि प क ् ष |
विपक्षनेतृपदस्य	व ि प क ् ष न े त ृ प द स ् य |
विपक्षिदलानां	व ि प क ् ष ि द ल ा न ा ं |
विपणिमूल्येन्	व ि प ण ि म ू ल ् य े न ् |
विपणीभ्यश्च	व ि प ण ी भ ् य श ् च |
विपणौ	व ि प ण ौ |
विप्लव	व ि प ् ल व |
विफला	व ि फ ल ा |
विफ़लो	व ि फ ़ ल ो |
विभागः	व ि भ ा ग ः |
विभागस्य	व ि भ ा ग स ् य |
विभागानां	व ि भ ा ग ा न ा ं |
विभागेन	व ि भ ा ग े न |
विभाजनविषयकं	व ि भ ा ज न व ि ष य क ं |
विभिन्न	व ि भ ि न ् न |
विभिन्नानां	व ि भ ि न ् न ा न ा ं |
विभिन्नेषु	व ि भ ि न ् न े ष ु |
विभ्रष्टेष्टि	व ि भ ् र ष ् ट े ष ् ट ि |
विमर्शाश्च	व ि म र ् श ा श ् च |
विमानेन	व ि म ा न े न |
विमानैः	व ि म ा न ै ः |
विमिन्नेषु	व ि म ि न ् न े ष ु |
विमुक्तये	व ि म ु क ् त य े |
विमृश्यमाने	व ि म ृ श ् य म ा न े |
विमोचनाय	व ि म ो च न ा य |
विमोचनार्थं	व ि म ो च न ा र ् थ ं |
विमोच्यन्ते	व ि म ो च ् य न ् त े |
विरचयितुं	व ि र च य ि त ु ं |
विरचितं	व ि र च ि त ं |
विरचितः	व ि र च ि त ः |
विरचितवान्	व ि र च ि त व ा न ् |
विरलद्रव्यरूपेण	व ि र ल द ् र व ् य र ू प े ण |
विराजः	व ि र ा ज ः |
विराजते	व ि र ा ज त े |
विराट्	व ि र ा ट ् |
विराडित्युच्यते	व ि र ा ड ि त ् य ु च ् य त े |
विराड्पुरुषः	व ि र ा ड ् प ु र ु ष ः |
विराड्पुरुषादेव	व ि र ा ड ् प ु र ु ष ा द े व |
विरामस्य	व ि र ा म स ् य |
विरामाय	व ि र ा म ा य |
विरामोल्लंघनं	व ि र ा म ो ल ् ल ं घ न ं |
विरामोल्लङ्घनं	व ि र ा म ो ल ् ल ङ ् घ न ं |
विरीहिपाक	व ि र ी ह ि प ा क |
विरुद्धं	व ि र ु द ् ध ं |
विरुद्ध्य	व ि र ु द ् ध ् य |
विरुध्य	व ि र ु ध ् य |
विरूद्ध्य	व ि र ू द ् ध ् य |
विरूध्य	व ि र ू ध ् य |
विरोध	व ि र ो ध |
विरोधाचरणं	व ि र ो ध ा च र ण ं |
विरोधि	व ि र ो ध ि |
विरोधिनां	व ि र ो ध ि न ा ं |
विरोधो	व ि र ो ध ो |
विलम्बकारणात्	व ि ल म ् ब क ा र ण ा त ् |
विलसन्ति	व ि ल स न ् त ि |
विवः	व ि व ः |
विवक्षया	व ि व क ् ष य ा |
विवक्षितं	व ि व क ् ष ि त ं |
विवरण	व ि व र ण |
विवरणं	व ि व र ण ं |
विवरणम्	व ि व र ण म ् |
विवरणार्थं	व ि व र ण ा र ् थ ं |
विवर्धयितुं	व ि व र ् ध य ि त ु ं |
विवर्धयितुम्	व ि व र ् ध य ि त ु म ् |
विवर्धितम्	व ि व र ् ध ि त म ् |
विवर्ध्य	व ि व र ् ध ् य |
विवादं	व ि व ा द ं |
विवादग्रस्तानि	व ि व ा द ग ् र स ् त ा न ि |
विवादम्	व ि व ा द म ् |
विवादास्पदं	व ि व ा द ा स ् प द ं |
विवादो	व ि व ा द ो |
विवाहस्य	व ि व ा ह स ् य |
विवाहाः	व ि व ा ह ा ः |
विवाहादिकं	व ि व ा ह ा द ि क ं |
विवाहादिषु	व ि व ा ह ा द ि ष ु |
विवाहो	व ि व ा ह ो |
विविदिषन्ति	व ि व ि द ि ष न ् त ि |
विविधान्विषयान्	व ि व ि ध ा न ् व ि ष य ा न ् |
विवेक	व ि व े क |
विवेक्तव्यमिति	व ि व े क ् त व ् य म ि त ि |
विवेक्तुं	व ि व े क ् त ु ं |
विशाखान्तानि	व ि श ा ख ा न ् त ा न ि |
विशिष्ट	व ि श ि ष ् ट |
विशिष्टयोजनाः	व ि श ि ष ् ट य ो ज न ा ः |
विशिष्टशौर्यसेवार्थं	व ि श ि ष ् ट श ौ र ् य स े व ा र ् थ ं |
विशिष्टान्वीक्षणवृन्दमेकं	व ि श ि ष ् ट ा न ् व ी क ् ष ण व ृ न ् द म े क ं |
विशिष्टो	व ि श ि ष ् ट ो |
विशिष्टोपलब्धिः	व ि श ि ष ् ट ो प ल ब ् ध ि ः |
विशिष्टोपवेशने	व ि श ि ष ् ट ो प व े श न े |
विशेष	व ि श े ष |
विशेषः	व ि श े ष ः |
विशेषतः	व ि श े ष त ः |
विशेषान्वीक्षण	व ि श े ष ा न ् व ी क ् ष ण |
विशेषाभियान	व ि श े ष ा भ ि य ा न |
विशेषावधानप्रदानार्थं	व ि श े ष ा व ध ा न प ् र द ा न ा र ् थ ं |
विशेषेण	व ि श े ष े ण |
विश्व	व ि श ् व |
विश्वस्य	व ि श ् व स ् य |
विश्वस्वास्थ्यसंघटनविषये	व ि श ् व स ् व ा स ् थ ् य स ं घ ट न व ि ष य े |
विष	व ि ष |
विषमसत्य	व ि ष म स त ् य |
विषय	व ि ष य |
विषयः	व ि ष य ः |
विषयकं	व ि ष य क ं |
विषयकनिर्णयस्य	व ि ष य क न ि र ् ण य स ् य |
विषयको	व ि ष य क ो |
विषयाः	व ि ष य ा ः |
विषयान्	व ि ष य ा न ् |
विषये	व ि ष य े |
विषयेषु	व ि ष य े ष ु |
विषसमानान्	व ि ष स म ा न ा न ् |
विसर्जनं	व ि स र ् ज न ं |
विस्खलन	व ि स ् ख ल न |
विस्तरेण	व ि स ् त र े ण |
विस्तृतंविवरणं	व ि स ् त ृ त ं व ि व र ण ं |
विस्तृतस्य	व ि स ् त ृ त स ् य |
विस्फ़ोटाक्रमणत्रये	व ि स ् फ ़ ो ट ा क ् र म ण त ् र य े |
विस्फोटक	व ि स ् फ ो ट क |
विस्फोटकानि	व ि स ् फ ो ट क ा न ि |
विस्फोटेन	व ि स ् फ ो ट े न |
विहाय	व ि ह ा य |
विहित	व ि ह ि त |
विहितं	व ि ह ि त ं |
विहितः	व ि ह ि त ः |
विहितमस्ति	व ि ह ि त म स ् त ि |
विहितम्	व ि ह ि त म ् |
विहितवन्तौ	व ि ह ि त व न ् त ौ |
विहिता	व ि ह ि त ा |
विहिताक्रमणप्रसङ्गे	व ि ह ि त ा क ् र म ण प ् र स ङ ् ग े |
विहितानि	व ि ह ि त ा न ि |
विहितायाः	व ि ह ि त ा य ा ः |
विहितास्ति	व ि ह ि त ा स ् त ि |
विहितेषु	व ि ह ि त े ष ु |
विहितैः	व ि ह ि त ै ः |
विहितो	व ि ह ि त ो |
विहित्	व ि ह ि त ् |
वीणा	व ी ण ा |
वीर	व ी र |
वीरगतिं	व ी र ग त ि ं |
वीहिपाकादि	व ी ह ि प ा क ा द ि |
वुष्टिः	व ु ष ् ट ि ः |
वृक्ष	व ृ क ् ष |
वृक्षस्य	व ृ क ् ष स ् य |
वृक्षेषु	व ृ क ् ष े ष ु |
वृतास्यात्	व ृ त ा स ् य ा त ् |
वृत्तं	व ृ त ् त ं |
वृत्तम्	व ृ त ् त म ् |
वृत्रं	व ृ त ् र ं |
वृद्धिः	व ृ द ् ध ि ः |
वृद्धिपीडिताः	व ृ द ् ध ि प ी ड ि त ा ः |
वृद्धिम्	व ृ द ् ध ि म ् |
वृद्धिरियं	व ृ द ् ध ि र ि य ं |
वृद्धिविषयकः	व ृ द ् ध ि व ि ष य क ः |
वृध्देः	व ृ ध ् द े ः |
वृध्यर्थं	व ृ ध ् य र ् थ ं |
वृन्दं	व ृ न ् द ं |
वृन्दानि	व ृ न ् द ा न ि |
वृन्देन	व ृ न ् द े न |
वृश्चिकभिया	व ृ श ् च ि क भ ि य ा |
वृषभशकटानां	व ृ ष भ श क ट ा न ा ं |
वृषभाणां	व ृ ष भ ा ण ा ं |
वृष्टि	व ृ ष ् ट ि |
वृष्टेः	व ृ ष ् ट े ः |
वृष्टेरन्नं	व ृ ष ् ट े र न ् न ं |
वृष्णीनां	व ृ ष ् ण ी न ा ं |
वे	व े |
वेंकय्या	व े ं क य ् य ा |
वेंकय्यानायडूः	व े ं क य ् य ा न ा य ड ू ः |
वेग	व े ग |
वेद	व े द |
वेदनित्यत्वन्तु	व े द न ि त ् य त ् व न ् त ु |
वेदमन्त्रपूर्वकं	व े द म न ् त ् र प ू र ् व क ं |
वेदमन्त्रपूर्वके	व े द म न ् त ् र प ू र ् व क े |
वेदविहितत्वात्	व े द व ि ह ि त त ् व ा त ् |
वेदस्य	व े द स ् य |
वेदाङ्गत्वात्	व े द ा ङ ् ग त ् व ा त ् |
वेदाङ्गेषु	व े द ा ङ ् ग े ष ु |
वेदाधिकारिणः	व े द ा ध ि क ा र ि ण ः |
वेदाध्ययनं	व े द ा ध ् य य न ं |
वेदाध्ययनमूलंकुत्वा	व े द ा ध ् य य न म ू ल ं क ु त ् व ा |
वेदाध्ययनातन्तरं	व े द ा ध ् य य न ा त न ् त र ं |
वेदाध्ययनेन	व े द ा ध ् य य न े न |
वेदानुवचनेन	व े द ा न ु व च न े न |
वेदान्तेषु	व े द ा न ् त े ष ु |
वेदार्थ	व े द ा र ् थ |
वेदार्थसारभूताः	व े द ा र ् थ स ा र भ ू त ा ः |
वेदाश्च	व े द ा श ् च |
वेदास्तु	व े द ा स ् त ु |
वेदिकायाः	व े द ि क ा य ा ः |
वेदे	व े द े |
वेदेषु	व े द े ष ु |
वेदेष्वपि	व े द े ष ् व प ि |
वेदोक्तः	व े द ो क ् त ः |
वेदोक्तान	व े द ो क ् त ा न |
वेदोक्तानि	व े द ो क ् त ा न ि |
वेदोक्तासृष्टिस्तु	व े द ो क ् त ा स ृ ष ् ट ि स ् त ु |
वेष्टनात्	व े ष ् ट न ा त ् |
वेष्टने	व े ष ् ट न े |
वेष्टवेन	व े ष ् ट व े न |
वेस्ट्	व े स ् ट ् |
वै	व ै |
वैकुण्ठं	व ै क ु ण ् ठ ं |
वैदिकं	व ै द ि क ं |
वैदिकविदुषाम्	व ै द ि क व ि द ु ष ा म ् |
वैदिकहाफ़िज़सम्भाषणम्	व ै द ि क ह ा फ ़ ि ज ़ स म ् भ ा ष ण म ् |
वैदिकी	व ै द ि क ी |
वैदिके	व ै द ि क े |
वैदेशिक	व ै द े श ि क |
वैदेशिकस्य	व ै द े श ि क स ् य |
वैद्युताणविक	व ै द ् य ु त ा ण व ि क |
वैफ़ल्यार्थं	व ै फ ़ ल ् य ा र ् थ ं |
वैमानिक्	व ै म ा न ि क ् |
वैमानिक्स्रोतांसि	व ै म ा न ि क ् स ् र ो त ा ं स ि |
वैशरीरी	व ै श र ी र ी |
वैश्वदेव	व ै श ् व द े व |
वैश्वदेवाख्यानां	व ै श ् व द े व ा ख ् य ा न ा ं |
वैषम्यं	व ै ष म ् य ं |
व्	व ् |
व्दितीयसप्ताहे	व ् द ि त ी य स प ् त ा ह े |
व्यक्तिकाश्च	व ् य क ् त ि क ा श ् च |
व्यख्यास्यामः	व ् य ख ् य ा स ् य ा म ः |
व्यजयत्	व ् य ज य त ् |
व्यतिरिक्त	व ् य त ि र ि क ् त |
व्यदधात्	व ् य द ध ा त ् |
व्यपदिश्येत	व ् य प द ि श ् य े त |
व्यय	व ् य य |
व्ययः	व ् य य ः |
व्ययार्थम्	व ् य य ा र ् थ म ् |
व्यवस्था	व ् य व स ् थ ा |
व्यवस्थां	व ् य व स ् थ ा ं |
व्यवस्थात्	व ् य व स ् थ ा त ् |
व्यवस्थायाः	व ् य व स ् थ ा य ा ः |
व्यवस्थायाम्	व ् य व स ् थ ा य ा म ् |
व्यवस्थायै	व ् य व स ् थ ा य ै |
व्यवस्थाश्च	व ् य व स ् थ ा श ् च |
व्यवहार	व ् य व ह ा र |
व्याकतत्वेन	व ् य ा क त त ् व े न |
व्याकरणम्	व ् य ा क र ण म ् |
व्याकरणस्य	व ् य ा क र ण स ् य |
व्याकृतं	व ् य ा क ृ त ं |
व्याकृतमेव	व ् य ा क ृ त म े व |
व्याख्यस्यामः	व ् य ा ख ् य स ् य ा म ः |
व्याख्याते	व ् य ा ख ् य ा त े |
व्याख्यातेषु	व ् य ा ख ् य ा त े ष ु |
व्याख्यानं	व ् य ा ख ् य ा न ं |
व्याख्यानम्	व ् य ा ख ् य ा न म ् |
व्याख्यानानन्तरं	व ् य ा ख ् य ा न ा न न ् त र ं |
व्याख्यास्यामः	व ् य ा ख ् य ा स ् य ा म ः |
व्याघ्रभीतः	व ् य ा घ ् र भ ी त ः |
व्यापकं	व ् य ा प क ं |
व्यापादयत्	व ् य ा प ा द य त ् |
व्यापादितः	व ् य ा प ा द ि त ः |
व्यापादितवन्ति	व ् य ा प ा द ि त व न ् त ि |
व्यापादिताः	व ् य ा प ा द ि त ा ः |
व्यापादितौ	व ् य ा प ा द ि त ौ |
व्यापारं	व ् य ा प ा र ं |
व्यापारसीमक्षेत्रार्थव्यवस्था	व ् य ा प ा र स ी म क ् ष े त ् र ा र ् थ व ् य व स ् थ ा |
व्यापारार्थव्यवस्थाजन	व ् य ा प ा र ा र ् थ व ् य व स ् थ ा ज न |
व्याप्त्यर्थः	व ् य ा प ् त ् य र ् थ ः |
व्यार्ध्यत	व ् य ा र ् ध ् य त |
व्यास	व ् य ा स |
व्यासनद्यां	व ् य ा स न द ् य ा ं |
व्याहरत्	व ् य ा ह र त ् |
व्याहृते	व ् य ा ह ृ त े |
व्युत्पन्नः	व ् य ु त ् प न ् न ः |
व्रणितं	व ् र ण ि त ं |
व्रणितः	व ् र ण ि त ः |
व्रणिताः	व ् र ण ि त ा ः |
व्रत	व ् र त |
शंकरः	श ं क र ः |
शंकरप्रसादः	श ं क र प ् र स ा द ः |
शंकरस्य	श ं क र स ् य |
शकुनिं	श क ु न ि ं |
शक्तिरूपः	श क ् त ि र ू प ः |
शक्त्यात्मकः	श क ् त ् य ा त ् म क ः |
शक्नोति	श क ् न ो त ि |
शक्यते	श क ् य त े |
शक्यमिति	श क ् य म ि त ि |
शक्यम्	श क ् य म ् |
शक्ष्यन्ते	श क ् ष ् य न ् त े |
शत	श त |
शतं	श त ं |
शतकीया	श त क ी य ा |
शतशतध्नीनां	श त श त ध ् न ी न ा ं |
शताब्दस्यास्य	श त ा ब ् द स ् य ा स ् य |
शतेन	श त े न |
शतोत्तरसप्त	श त ो त ् त र स प ् त |
शतोत्तरै	श त ो त ् त र ै |
शत्रून्	श त ् र ू न ् |
शनिवासरानन्तरं	श न ि व ा स र ा न न ् त र ं |
शनिवासरे	श न ि व ा स र े |
शनैः	श न ै ः |
शपथ	श प थ |
शपथग्रहणसमारम्भात्	श प थ ग ् र ह ण स म ा र म ् भ ा त ् |
शपथग्रहणसमारोहे	श प थ ग ् र ह ण स म ा र ो ह े |
शपथविधामुपलक्ष्य	श प थ व ि ध ा म ु प ल क ् ष ् य |
शपथविधायाः	श प थ व ि ध ा य ा ः |
शपथसमारम्भे	श प थ स म ा र म ् भ े |
शब्द	श ब ् द |
शब्दः	श ब ् द ः |
शब्दग्रहणं	श ब ् द ग ् र ह ण ं |
शब्देन	श ब ् द े न |
शब्दो	श ब ् द ो |
शम्भुः	श म ् भ ु ः |
शरदयादवेनोक्तं	श र द य ा द व े न ो क ् त ं |
शरीफ़ः	श र ी फ ़ ः |
शरीफ़स्य	श र ी फ ़ स ् य |
शरीरं	श र ी र ं |
शवाः	श व ा ः |
शशि	श श ि |
शस्त्रा	श स ् त ् र ा |
शस्त्राशस्त्रयुतैः	श स ् त ् र ा श स ् त ् र य ु त ै ः |
शस्त्रास्त्राणि	श स ् त ् र ा स ् त ् र ा ण ि |
शस्यानां	श स ् य ा न ा ं |
शस्यानि	श स ् य ा न ि |
शहनाईवादकस्य	श ह न ा ई व ा द क स ् य |
शहनाईवादनम्	श ह न ा ई व ा द न म ् |
शाखा	श ा ख ा |
शाखाः	श ा ख ा ः |
शाखाम्	श ा ख ा म ् |
शाखायां	श ा ख ा य ा ं |
शाखायाः	श ा ख ा य ा ः |
शाखिनां	श ा ख ि न ा ं |
शाज़ियाइल्मीजी	श ा ज ़ ि य ा इ ल ् म ी ज ी |
शाजियाइल्मी	श ा ज ि य ा इ ल ् म ी |
शान्तिं	श ा न ् त ि ं |
शारदापर्णीनिधिप्रकरणं	श ा र द ा प र ् ण ी न ि ध ि प ् र क र ण ं |
शारदालघु	श ा र द ा ल घ ु |
शारदावर्गीयप्रमुखं	श ा र द ा व र ् ग ी य प ् र म ु ख ं |
शारापोवा	श ा र ा प ो व ा |
शासकीयसाहाय्य	श ा स क ी य स ा ह ा य ् य |
शासनाधिकारावाप्तिं	श ा स न ा ध ि क ा र ा व ा प ् त ि ं |
शासनार्थं	श ा स न ा र ् थ ं |
शासनिकापणैः	श ा स न ि क ा प ण ै ः |
शास्त्र	श ा स ् त ् र |
शास्त्रम्	श ा स ् त ् र म ् |
शास्त्रेषु	श ा स ् त ् र े ष ु |
शिंज़ो	श ि ं ज ़ ो |
शिक्षकसंस्थाभिश्च	श ि क ् ष क स ं स ् थ ा भ ि श ् च |
शिक्षकांश्च	श ि क ् ष क ा ं श ् च |
शिक्षक्संस्थाभिश्च	श ि क ् ष क ् स ं स ् थ ा भ ि श ् च |
शिक्षाविद्भिः	श ि क ् ष ा व ि द ् भ ि ः |
शिखर	श ि ख र |
शिखरोपवेशनानन्तरं	श ि ख र ो प व े श न ा न न ् त र ं |
शिथिलितप्रावृट्स्थितिं	श ि थ ि ल ि त प ् र ा व ृ ट ् स ् थ ि त ि ं |
शिथिलीकर्तुं	श ि थ ि ल ी क र ् त ु ं |
शिरसि	श ि र स ि |
शिवः	श ि व ः |
शिविरं	श ि व ि र ं |
शिविराणि	श ि व ि र ा ण ि |
शिविरात्	श ि व ि र ा त ् |
शिविरेषु	श ि व ि र े ष ु |
शिशुपालं	श ि श ु प ा ल ं |
शिष्टपरिग्रहत्वात्	श ि ष ् ट प र ि ग ् र ह त ् व ा त ् |
शिष्टाः	श ि ष ् ट ा ः |
शीघ्रमेव	श ी घ ् र म े व |
शीतः	श ी त ः |
शीतकालिक्	श ी त क ा ल ि क ् |
शीतमित्युच्यते	श ी त म ि त ् य ु च ् य त े |
शीतशैत्युच्यते	श ी त श ै त ् य ु च ् य त े |
शीतिसहस्राधिकैकलक्षकोटि	श ी त ि स ह स ् र ा ध ि क ै क ल क ् ष क ो ट ि |
शील	श ी ल |
शीलसन्धे	श ी ल स न ् ध े |
शुक्रवासरे	श ु क ् र व ा स र े |
शुचित्वं	श ु च ि त ् व ं |
शुचित्वन्तु	श ु च ि त ् व न ् त ु |
शुचिना	श ु च ि न ा |
शुभं	श ु भ ं |
शुभारम्भं	श ु भ ा र म ् भ ं |
शुल्कं	श ु ल ् क ं |
शुल्कमुक्तं	श ु ल ् क म ु क ् त ं |
शुल्कम्	श ु ल ् क म ् |
शुल्केषु	श ु ल ् क े ष ु |
शृङ्खलां	श ृ ङ ् ख ल ा ं |
शृड्खलामेनां	श ृ ड ् ख ल ा म े न ा ं |
शृणुमः	श ृ ण ु म ः |
शेक्यं	श े क ् य ं |
शेखर	श े ख र |
शैक्या	श ै क ् य ा |
शैक्षणिक	श ै क ् ष ण ि क |
शैथिल्य	श ै थ ि ल ् य |
शैथिल्यं	श ै थ ि ल ् य ं |
शैथिल्यप्रदानं	श ै थ ि ल ् य प ् र द ा न ं |
शैथिल्येन	श ै थ ि ल ् य े न |
शैल	श ै ल |
शैली	श ै ल ी |
शोधक्यन्त्राणि	श ो ध क ् य न ् त ् र ा ण ि |
शोधपराः	श ो ध प र ा ः |
शोभनीयाः	श ो भ न ी य ा ः |
शौर्य	श ौ र ् य |
श्यात्	श ् य ा त ् |
श्रद्धाञ्जलीन्	श ् र द ् ध ा ञ ् ज ल ी न ् |
श्रद्धालवः	श ् र द ् ध ा ल व ः |
श्रमिकाणां	श ् र म ि क ा ण ा ं |
श्रमेण	श ् र म े ण |
श्रवण	श ् र व ण |
श्रवणं	श ् र व ण ं |
श्रव्य	श ् र व ् य |
श्राद्ध	श ् र ा द ् ध |
श्राद्धं	श ् र ा द ् ध ं |
श्रावणीय	श ् र ा व ण ी य |
श्रावयिष्यते	श ् र ा व य ि ष ् य त े |
श्री	श ् र ी |
श्रीकान्तश्च	श ् र ी क ा न ् त श ् च |
श्रीकृष्णः	श ् र ी क ृ ष ् ण ः |
श्रीकृष्णे	श ् र ी क ृ ष ् ण े |
श्रीगुरवे	श ् र ी ग ु र व े |
श्रीनगरे	श ् र ी न ग र े |
श्रीनरेन्द्रमोदी	श ् र ी न र े न ् द ् र म ो द ी |
श्रीनायडूः	श ् र ी न ा य ड ू ः |
श्रीमत	श ् र ी म त |
श्रीमता	श ् र ी म त ा |
श्रीमती	श ् र ी म त ी |
श्रीमोदिनः	श ् र ी म ो द ि न ः |
श्रीमोदिनश्चयनानन्तरं	श ् र ी म ो द ि न श ् च य न ा न न ् त र ं |
श्रीमोदी	श ् र ी म ो द ी |
श्रीलङ्का	श ् र ी ल ङ ् क ा |
श्रीलङ्कापाकिस्तानयोः	श ् र ी ल ङ ् क ा प ा क ि स ् त ा न य ो ः |
श्रीलड्कादेशीयाः	श ् र ी ल ड ् क ा द े श ी य ा ः |
श्रीलाल्	श ् र ी ल ा ल ् |
श्रीवांगयिः	श ् र ी व ा ं ग य ि ः |
श्रीसत्यार्थी	श ् र ी स त ् य ा र ् थ ी |
श्रुतम्	श ् र ु त म ् |
श्रुतिः	श ् र ु त ि ः |
श्रुतिरेव	श ् र ु त ि र े व |
श्रुतिविहितं	श ् र ु त ि व ि ह ि त ं |
श्रुतिविहितानां	श ् र ु त ि व ि ह ि त ा न ा ं |
श्रुतिविहितानि	श ् र ु त ि व ि ह ि त ा न ि |
श्रुतौ	श ् र ु त ौ |
श्रुत्या	श ् र ु त ् य ा |
श्रुत्याविहितो	श ् र ु त ् य ा व ि ह ि त ो |
श्रेयः	श ् र े य ः |
श्रेष्ठप्रदर्शनार्थम्	श ् र े ष ् ठ प ् र द र ् श न ा र ् थ म ् |
श्रेष्ठा	श ् र े ष ् ठ ा |
श्रोतुमद्य	श ् र ो त ु म द ् य |
श्रौत	श ् र ौ त |
श्रौतं	श ् र ौ त ं |
श्रौतकर्म	श ् र ौ त क र ् म |
श्रौतानि	श ् र ौ त ा न ि |
श्लेष्महारिणी	श ् ल े ष ् म ह ा र ि ण ी |
श्लोकः	श ् ल ो क ः |
श्वः	श ् व ः |
श्वस्तनमतगणनायै	श ् व स ् त न म त ग ण न ा य ै |
श्वासोच्छायवस्वादिष्वपि	श ् व ा स ो च ् छ ा य व स ् व ा द ि ष ् व प ि |
श्वेतच्छत्रं	श ् व े त च ् छ त ् र ं |
श्वो	श ् व ो |
षट्	ष ट ् |
षट्चत्वारिंशद्	ष ट ् च त ् व ा र ि ं श द ् |
षट्त्रिंशत्तमम्	ष ट ् त ् र ि ं श त ् त म म ् |
षट्षष्टिदशमलवद्धिसप्तातिमितं	ष ट ् ष ष ् ट ि द श म ल व द ् ध ि स प ् त ा त ि म ि त ं |
षट्सहस्रमिताः	ष ट ् स ह स ् र म ि त ा ः |
षट्सु	ष ट ् स ु |
षडविंशाधिकैकशतं	ष ड व ि ं श ा ध ि क ै क श त ं |
षडशीतितमे	ष ड श ी त ि त म े |
षड्	ष ड ् |
षड्वादनं	ष ड ् व ा द न ं |
षड्विंशे	ष ड ् व ि ं श े |
षण्मितं	ष ण ् म ि त ं |
षष्टि	ष ष ् ट ि |
षष्टिः	ष ष ् ट ि ः |
षष्टिवर्ष	ष ष ् ट ि व र ् ष |
षष्टिवर्षेभ्यः	ष ष ् ट ि व र ् ष े भ ् य ः |
षष्टेः	ष ष ् ट े ः |
षष्ट्यथिकैक	ष ष ् ट ् य थ ि क ै क |
षष्ठ	ष ष ् ठ |
षष्ठौ	ष ष ् ठ ौ |
षेषु	ष े ष ु |
षोडशी	ष ो ड श ी |
षोडश्याः	ष ो ड श ् य ा ः |
षोडस्याः	ष ो ड स ् य ा ः |
स	स |
संकट	स ं क ट |
संकल्प	स ं क ल ् प |
संकल्पीयसत्रानन्तरं	स ं क ल ् प ी य स त ् र ा न न ् त र ं |
संकेतितवत्	स ं क े त ि त व त ् |
संख्या	स ं ख ् य ा |
संघ	स ं घ |
संघटन	स ं घ ट न |
संघटनस्य	स ं घ ट न स ् य |
संघटनस्यानुसारि	स ं घ ट न स ् य ा न ु स ा र ि |
संघटनेन	स ं घ ट न े न |
संघटनैः	स ं घ ट न ै ः |
संघटनौश्च	स ं घ ट न ौ श ् च |
संघट्टनेन	स ं घ ट ् ट न े न |
संघट्टितम्	स ं घ ट ् ट ि त म ् |
संघर्ष	स ं घ र ् ष |
संघर्षः	स ं घ र ् ष ः |
संघर्षपीडितात्	स ं घ र ् ष प ी ड ि त ा त ् |
संघर्षविमा	स ं घ र ् ष व ि म ा |
संघर्षविरामोल्लंड्घनं	स ं घ र ् ष व ि र ा म ो ल ् ल ं ड ् घ न ं |
संघर्षे	स ं घ र ् ष े |
संघस्य	स ं घ स ् य |
संघीयस्वरूपं	स ं घ ी य स ् व र ू प ं |
संघेन	स ं घ े न |
संचयन्ति	स ं च य न ् त ि |
संचार	स ं च ा र |
संचाररोधः	स ं च ा र र ो ध ः |
संचाररोधशैथिल्यं	स ं च ा र र ो ध श ै थ ि ल ् य ं |
संचाररोधाः	स ं च ा र र ो ध ा ः |
संचाररोधादेशः	स ं च ा र र ो ध ा द े श ः |
संचाररोधे	स ं च ा र र ो ध े |
संचेतितं	स ं च े त ि त ं |
संजातभूस्खलनात्	स ं ज ा त भ ू स ् ख ल न ा त ् |
संजाता	स ं ज ा त ा |
संजाते	स ं ज ा त े |
संज्ञकाः	स ं ज ् ञ क ा ः |
संदर्भयन	स ं द र ् भ य न |
संदिग्ध	स ं द ि ग ् ध |
संदिग्धभारतीयानां	स ं द ि ग ् ध भ ा र त ी य ा न ा ं |
संदिग्धेः	स ं द ि ग ् ध े ः |
संपत्स्यते	स ं प त ् स ् य त े |
संपद्यते	स ं प द ् य त े |
संपर्करहितो	स ं प र ् क र ह ि त ो |
संपादनं	स ं प ा द न ं |
संप्रदायः	स ं प ् र द ा य ः |
संप्रदाये	स ं प ् र द ा य े |
संप्राप्स्यति	स ं प ् र ा प ् स ् य त ि |
संभक्तेषु	स ं भ क ् त े ष ु |
संभाव्यते	स ं भ ा व ् य त े |
संभूय	स ं भ ू य |
संभ्या	स ं भ ् य ा |
संयमेन	स ं य म े न |
संयुक्त	स ं य ु क ् त |
संयुक्तजनतादलाध्यक्षेण	स ं य ु क ् त ज न त ा द ल ा ध ् य क ् ष े ण |
संयुक्तराष्ट्र	स ं य ु क ् त र ा ष ् ट ् र |
संयुक्ताधिवेशनं	स ं य ु क ् त ा ध ि व े श न ं |
संयुतिः	स ं य ु त ि ः |
संयुतिसन्नीतेन	स ं य ु त ि स न ् न ी त े न |
संयोजकेन	स ं य ो ज क े न |
संरकृतफारसीअरबीप्राकृतभाषाणाम्	स ं र क ृ त फ ा र स ी अ र ब ी प ् र ा क ृ त भ ा ष ा ण ा म ् |
संरक्षणार्थं	स ं र क ् ष ण ा र ् थ ं |
संरक्षिताः	स ं र क ् ष ि त ा ः |
संरचनां	स ं र च न ा ं |
संरचयितुं	स ं र च य ि त ु ं |
संवर्धनार्थं	स ं व र ् ध न ा र ् थ ं |
संवर्धयितुं	स ं व र ् ध य ि त ु ं |
संवादं	स ं व ा द ं |
संवादे	स ं व ा द े |
संविधानस्य	स ं व ि ध ा न स ् य |
संवृत्ता	स ं व ृ त ् त ा |
संवृत्ताः	स ं व ृ त ् त ा ः |
संवृत्ते	स ं व ृ त ् त े |
संवृवृत्ताः	स ं व ृ व ृ त ् त ा ः |
संवेदना	स ं व े द न ा |
संवैधानिक	स ं व ै ध ा न ि क |
संशोधकेन	स ं श ो ध क े न |
संशोधिता	स ं श ो ध ि त ा |
संसद	स ं स द |
संसदः	स ं स द ः |
संसदि	स ं स द ि |
संसदीय	स ं स द ी य |
संसदीयकार्यमन्त्री	स ं स द ी य क ा र ् य म न ् त ् र ी |
संसदीयनिर्वाचनेषु	स ं स द ी य न ि र ् व ा च न े ष ु |
संसदीयासनानां	स ं स द ी य ा स न ा न ा ं |
संसदो	स ं स द ो |
संसूचितं	स ं स ू च ि त ं |
संसूच्यते	स ं स ू च ् य त े |
संस्कारे	स ं स ् क ा र े |
संस्कुत	स ं स ् क ु त |
संस्कृत	स ं स ् क ृ त |
संस्कृतं	स ं स ् क ृ त ं |
संस्कृतवार्ताः	स ं स ् क ृ त व ा र ् त ा ः |
संस्कृतानुरागिणः	स ं स ् क ृ त ा न ु र ा ग ि ण ः |
संस्थाः	स ं स ् थ ा ः |
संस्थाने	स ं स ् थ ा न े |
संस्थापनाय	स ं स ् थ ा प न ा य |
संस्थापितम्	स ं स ् थ ा प ि त म ् |
संस्थाभि	स ं स ् थ ा भ ि |
संस्थायाः	स ं स ् थ ा य ा ः |
संस्पर्धन्ते	स ं स ् प र ् ध न ् त े |
संस्पर्धितानि	स ं स ् प र ् ध ि त ा न ि |
संस्पर्धिष्यन्ते	स ं स ् प र ् ध ि ष ् य न ् त े |
संहिता	स ं ह ि त ा |
संहितादयः	स ं ह ि त ा द य ः |
संहितायाः	स ं ह ि त ा य ा ः |
सः	स ः |
सकलगृहोत्पादस्य	स क ल ग ृ ह ो त ् प ा द स ् य |
सकस्संबन्ध	स क स ् स ं ब न ् ध |
सक्रियत्वं	स क ् र ि य त ् व ं |
सखायः	स ख ा य ः |
सगौरीकः	स ग ौ र ी क ः |
सङ्क्षेपेण	स ङ ् क ् ष े प े ण |
सङ्गणक	स ङ ् ग ण क |
सङ्गतः	स ङ ् ग त ः |
सङ्गतत्वात्	स ङ ् ग त त ् व ा त ् |
सङ्ग्रहरूपेण	स ङ ् ग ् र ह र ू प े ण |
सचिवत्वेन	स च ि व त ् व े न |
सचिवालयस्य	स च ि व ा ल य स ् य |
सचिवेन	स च ि व े न |
सज्जीकृतवान्	स ज ् ज ी क ृ त व ा न ् |
सज्जीकृताः	स ज ् ज ी क ृ त ा ः |
सज्जीभविता	स ज ् ज ी भ व ि त ा |
सञ्चरन्ति	स ञ ् च र न ् त ि |
सञ्चायकानां	स ञ ् च ा य क ा न ा ं |
सञ्चाररोधादेशम्	स ञ ् च ा र र ो ध ा द े श म ् |
सञ्जाते	स ञ ् ज ा त े |
सञ्जाररोधशैथिल्यं	स ञ ् ज ा र र ो ध श ै थ ि ल ् य ं |
सड्ग्रहरूपेण	स ड ् ग ् र ह र ू प े ण |
सततं	स त त ं |
सततम्	स त त म ् |
सतनाजनपदे	स त न ा ज न प द े |
सति	स त ि |
सत्यपि	स त ् य प ि |
सत्यभामा	स त ् य भ ा म ा |
सत्रमासत	स त ् र म ा स त |
सत्रस्य	स त ् र स ् य |
सत्रात्	स त ् र ा त ् |
सत्वरं	स त ् व र ं |
सदनद्वयस्य	स द न द ् व य स ् य |
सदनस्य	स द न स ् य |
सदनाभ्यां	स द न ा भ ् य ा ं |
सदनाभ्याम्	स द न ा भ ् य ा म ् |
सदने	स द न े |
सदस्य	स द स ् य |
सदस्यात्मकेन	स द स ् य ा त ् म क े न |
सदस्यानां	स द स ् य ा न ा ं |
सदस्यान्	स द स ् य ा न ् |
सदस्यैः	स द स ् य ै ः |
सदानन्दगौडाअभिभाषितवान्	स द ा न न ् द ग ौ ड ा अ भ ि भ ा ष ि त व ा न ् |
सद्भावं	स द ् भ ा व ं |
सद्य	स द ् य |
सद्यः	स द ् य ः |
सद्यस्तनीयः	स द ् य स ् त न ी य ः |
सद्यो	स द ् य ो |
सन्ति	स न ् त ि |
सन्तोलनपुरस्सरं	स न ् त ो ल न प ु र स ् स र ं |
सन्तोलितां	स न ् त ो ल ि त ा ं |
सन्तोषप्रदा	स न ् त ो ष प ् र द ा |
सन्देशं	स न ् द े श ं |
सन्धि	स न ् ध ि |
सन्धेः	स न ् ध े ः |
सन्नद्धाः	स न ् न द ् ध ा ः |
सन्नद्धास्ति	स न ् न द ् ध ा स ् त ि |
सन्निधौ	स न ् न ि ध ौ |
सन्नीतं	स न ् न ी त ं |
सपादशततमं	स प ा द श त त म ं |
सपुत्रः	स प ु त ् र ः |
सप्त	स प ् त |
सप्तति	स प ् त त ि |
सप्तत्यधिक्पंच	स प ् त त ् य ध ि क ् प ं च |
सप्तम	स प ् त म |
सप्तमे	स प ् त म े |
सप्तवादनपर्यन्तं	स प ् त व ा द न प र ् य न ् त ं |
सप्तविंशे	स प ् त व ि ं श े |
सप्ताह	स प ् त ा ह |
सप्ताहे	स प ् त ा ह े |
सफला	स फ ल ा |
सफ़लं	स फ ़ ल ं |
सफ़लतायै	स फ ़ ल त ा य ै |
सबन्धो	स ब न ् ध ो |
सभा	स भ ा |
सभां	स भ ा ं |
सभाजितः	स भ ा ज ि त ः |
सभाजितवान्	स भ ा ज ि त व ा न ् |
सभाजिताः	स भ ा ज ि त ा ः |
सभायां	स भ ा य ा ं |
सभायाम्	स भ ा य ा म ् |
सम	स म |
समं	स म ं |
समक्षमागमिष्यन्ति	स म क ् ष म ा ग म ि ष ् य न ् त ि |
समग्रां	स म ग ् र ा ं |
समन्वयको	स म न ् व य क ो |
समन्वितनीतेश्च	स म न ् व ि त न ी त े श ् च |
समन्वितसंवादकार्यक्रमः	स म न ् व ि त स ं व ा द क ा र ् य क ् र म ः |
समपदस्थः	स म प द स ् थ ः |
समभाषत	स म भ ा ष त |
समभिनन्दितवन्तः	स म भ ि न न ् द ि त व न ् त ः |
सममपि	स म म प ि |
समम्	स म म ् |
समयः	स म य ः |
समयमूलाः	स म य म ू ल ा ः |
समयाचाराः	स म य ा च ा र ा ः |
समरवीरा	स म र व ी र ा |
समर्जितम्	स म र ् ज ि त म ् |
समर्थः	स म र ् थ ः |
समर्थयिता	स म र ् थ य ि त ा |
समर्पयति	स म र ् प य त ि |
समर्पिताः	स म र ् प ि त ा ः |
समर्प्य	स म र ् प ् य |
समवरुद्धानां	स म व र ु द ् ध ा न ा ं |
समवेताः	स म व े त ा ः |
समष्टिप्राणः	स म ष ् ट ि प ् र ा ण ः |
समस्तस्य	स म स ् त स ् य |
समस्याः	स म स ् य ा ः |
समस्यासमाधानार्थं	स म स ् य ा स म ा ध ा न ा र ् थ ं |
समा	स म ा |
समाकारितम्	स म ा क ा र ि त म ् |
समाकारितवान्	स म ा क ा र ि त व ा न ् |
समाकारितस्य	स म ा क ा र ि त स ् य |
समागतस्य	स म ा ग त स ् य |
समाधातुं	स म ा ध ा त ु ं |
समाधान	स म ा ध ा न |
समाधृतान्	स म ा ध ृ त ा न ् |
समाधेयम्	स म ा ध े य म ् |
समापद्यमानाः	स म ा प द ् य म ा न ा ः |
समापन्नेन	स म ा प न ् न े न |
समामन्त्रितः	स म ा म न ् त ् र ि त ः |
समामन्त्रितम्	स म ा म न ् त ् र ि त म ् |
समामन्त्रिताः	स म ा म न ् त ् र ि त ा ः |
समायोजयति	स म ा य ो ज य त ि |
समायोजयत्	स म ा य ो ज य त ् |
समायोजितः	स म ा य ो ज ि त ः |
समायोजिते	स म ा य ो ज ि त े |
समायोजिष्यमाणे	स म ा य ो ज ि ष ् य म ा ण े |
समायोज्यते	स म ा य ो ज ् य त े |
समारंभे	स म ा र ं भ े |
समारब्धम्	स म ा र ब ् ध म ् |
समारब्धा	स म ा र ब ् ध ा |
समारोहे	स म ा र ो ह े |
समावर्तनं	स म ा व र ् त न ं |
समावर्तनस्य	स म ा व र ् त न स ् य |
समावेक्ष्यन्ते	स म ा व े क ् ष ् य न ् त े |
समाश्वासितम्	स म ा श ् व ा स ि त म ् |
समाश्वासितवान्	स म ा श ् व ा स ि त व ा न ् |
समाह्वानात्मिकां	स म ा ह ् व ा न ा त ् म ि क ा ं |
समितिरेका	स म ि त ि र े क ा |
समितीनां	स म ि त ी न ा ं |
समितेः	स म ि त े ः |
समित्या	स म ि त ् य ा |
समित्याः	स म ि त ् य ा ः |
समीक्षा	स म ी क ् ष ा |
समीक्षितानि	स म ी क ् ष ि त ा न ि |
समीक्षितुं	स म ी क ् ष ि त ु ं |
समीक्षितुम्	स म ी क ् ष ि त ु म ् |
समीचीनं	स म ी च ी न ं |
समीहते	स म ी ह त े |
समुचितं	स म ु च ि त ं |
समुचितमूल्येन	स म ु च ि त म ू ल ् य े न |
समुचितसाहाय्य	स म ु च ि त स ा ह ा य ् य |
समुत्पद्यमानाः	स म ु त ् प द ् य म ा न ा ः |
समुत्पन्ना	स म ु त ् प न ् न ा |
समुदायस्य	स म ु द ा य स ् य |
समुद्घोषितम्	स म ु द ् घ ो ष ि त म ् |
समुद्बोधितम्	स म ु द ् ब ो ध ि त म ् |
समुद्भूता	स म ु द ् भ ू त ा |
समुन्नतस्य	स म ु न ् न त स ् य |
समुपकल्पिते	स म ु प क ल ् प ि त े |
समुपचार्यते	स म ु प च ा र ् य त े |
समुपायजातं	स म ु प ा य ज ा त ं |
समूहयोर्मध्ये	स म ू ह य ो र ् म ध ् य े |
समृद्धिं	स म ृ द ् ध ि ं |
समेत्य	स म े त ् य |
समेषामपि	स म े ष ा म प ि |
समैक्षत	स म ै क ् ष त |
समैहत	स म ै ह त |
समोरोहे	स म ो र ो ह े |
सम्पद्यमाने	स म ् प द ् य म ा न े |
सम्पन्नतां	स म ् प न ् न त ा ं |
सम्पन्नम्	स म ् प न ् न म ् |
सम्पन्ना	स म ् प न ् न ा |
सम्पन्नाः	स म ् प न ् न ा ः |
सम्पर्कः	स म ् प र ् क ः |
सम्पर्कविनिमयसम्बद्धान्	स म ् प र ् क व ि न ि म य स म ् ब द ् ध ा न ् |
सम्पर्कादिविविधान्	स म ् प र ् क ा द ि व ि व ि ध ा न ् |
सम्पाद्य	स म ् प ा द ् य |
सम्पूर्णेपि	स म ् प ू र ् ण े प ि |
सम्प्रति	स म ् प ् र त ि |
सम्प्रत्यपि	स म ् प ् र त ् य प ि |
सम्प्रवर्तन्ते	स म ् प ् र व र ् त न ् त े |
सम्प्राप्तः	स म ् प ् र ा प ् त ः |
सम्प्राप्ताः	स म ् प ् र ा प ् त ा ः |
सम्प्राप्तानि	स म ् प ् र ा प ् त ा न ि |
सम्प्राप्नोति	स म ् प ् र ा प ् न ो त ि |
सम्प्राप्नोत्	स म ् प ् र ा प ् न ो त ् |
सम्प्राप्स्यति	स म ् प ् र ा प ् स ् य त ि |
सम्प्राप्स्यतीति	स म ् प ् र ा प ् स ् य त ी त ि |
सम्प्राप्स्यन्ति	स म ् प ् र ा प ् स ् य न ् त ि |
सम्प्रेरितमस्ति	स म ् प ् र े र ि त म स ् त ि |
सम्बद्धः	स म ् ब द ् ध ः |
सम्बन्धविभागीयप्रवक्ता	स म ् ब न ् ध व ि भ ा ग ी य प ् र व क ् त ा |
सम्बन्धाः	स म ् ब न ् ध ा ः |
सम्बन्धानां	स म ् ब न ् ध ा न ा ं |
सम्बन्धानाम्	स म ् ब न ् ध ा न ा म ् |
सम्बन्धान्	स म ् ब न ् ध ा न ् |
सम्बन्ध्	स म ् ब न ् ध ् |
सम्बोधने	स म ् ब ो ध न े |
सम्बोधयतिस्म	स म ् ब ो ध य त ि स ् म |
सम्बोधयन्	स म ् ब ो ध य न ् |
सम्बोधयिष्यति	स म ् ब ो ध य ि ष ् य त ि |
सम्बोधित्वान्	स म ् ब ो ध ि त ् व ा न ् |
सम्भविष्यति	स म ् भ व ि ष ् य त ि |
सम्भां	स म ् भ ा ं |
सम्भाषण	स म ् भ ा ष ण |
सम्भाषणं	स म ् भ ा ष ण ं |
सम्भाषणावसरे	स म ् भ ा ष ण ा व स र े |
सम्भाषणे	स म ् भ ा ष ण े |
सम्भाषते	स म ् भ ा ष त े |
सम्भाषमाणा	स म ् भ ा ष म ा ण ा |
सम्भाषमाणो	स म ् भ ा ष म ा ण ो |
सम्भूय	स म ् भ ू य |
सम्मर्शान्	स म ् म र ् श ा न ् |
सम्मर्षाः	स म ् म र ् ष ा ः |
सम्माननार्थं	स म ् म ा न न ा र ् थ ं |
सम्मिलति	स म ् म ि ल त ि |
सम्मुखी	स म ् म ु ख ी |
सम्मुखीकर्तुं	स म ् म ु ख ी क र ् त ु ं |
सम्मूर्च्छावस्थां	स म ् म ू र ् च ् छ ा व स ् थ ा ं |
सम्मेलनं	स म ् म े ल न ं |
सम्मेलनमेकम्	स म ् म े ल न म े क म ् |
सम्मेलनम्	स म ् म े ल न म ् |
सम्मेलनस्य	स म ् म े ल न स ् य |
सम्मेलने	स म ् म े ल न े |
सम्मेलिष्यति	स म ् म े ल ि ष ् य त ि |
सम्यक्	स म ् य क ् |
सरलीकर्तुं	स र ल ी क र ् त ु ं |
सर्पबलि	स र ् प ब ल ि |
सर्व	स र ् व |
सर्वं	स र ् व ं |
सर्वऋतवो	स र ् व ऋ त व ो |
सर्वकर्माण्यपि	स र ् व क र ् म ा ण ् य प ि |
सर्वगार्ह्य	स र ् व ग ा र ् ह ् य |
सर्वज्ञः	स र ् व ज ् ञ ः |
सर्वज्ञत्वस्य	स र ् व ज ् ञ त ् व स ् य |
सर्वज्ञाः	स र ् व ज ् ञ ा ः |
सर्वतोमुख	स र ् व त ो म ु ख |
सर्वत्	स र ् व त ् |
सर्वत्रापि	स र ् व त ् र ा प ि |
सर्वत्रो	स र ् व त ् र ो |
सर्वदैव	स र ् व द ै व |
सर्वप्रथमं	स र ् व प ् र थ म ं |
सर्वम्	स र ् व म ् |
सर्ववेद	स र ् व व े द |
सर्ववेदानां	स र ् व व े द ा न ा ं |
सर्ववेदार्थ	स र ् व व े द ा र ् थ |
सर्वसंभवसाहाय्यं	स र ् व स ं भ व स ा ह ा य ् य ं |
सर्वसम्भवोपायाः	स र ् व स म ् भ व ो प ा य ा ः |
सर्वसम्मत्या	स र ् व स म ् म त ् य ा |
सर्वसाधरणणां	स र ् व स ा ध र ण ण ा ं |
सर्वाः	स र ् व ा ः |
सर्वाण्यपि	स र ् व ा ण ् य प ि |
सर्वात्मना	स र ् व ा त ् म न ा |
सर्वाधिकं	स र ् व ा ध ि क ं |
सर्वानीन्द्रियकर्माणि	स र ् व ा न ी न ् द ् र ि य क र ् म ा ण ि |
सर्वान्	स र ् व ा न ् |
सर्वाय	स र ् व ा य |
सर्वासां	स र ् व ा स ा ं |
सर्वासुक्रियासु	स र ् व ा स ु क ् र ि य ा स ु |
सर्वे	स र ् व े |
सर्वेपि	स र ् व े प ि |
सर्वेप्राणिनः	स र ् व े प ् र ा ण ि न ः |
सर्वेव्यापारिताः	स र ् व े व ् य ा प ा र ि त ा ः |
सर्वेषां	स र ् व े ष ा ं |
सर्वेषु	स र ् व े ष ु |
सर्वैरपि	स र ् व ै र प ि |
सर्वोच्च	स र ् व ो च ् च |
सर्वोच्चन्यायालयस्य	स र ् व ो च ् च न ् य ा य ा ल य स ् य |
सवैः	स व ै ः |
सशस्त्रसेनार्थम्	स श स ् त ् र स े न ा र ् थ म ् |
सश्रद्धं	स श ् र द ् ध ं |
सह	स ह |
सहभागम्	स ह भ ा ग म ् |
सहभागित्वं	स ह भ ा ग ि त ् व ं |
सहभागित्वम्	स ह भ ा ग ि त ् व म ् |
सहभागित्वार्थं	स ह भ ा ग ि त ् व ा र ् थ ं |
सहभागित्वार्थम्	स ह भ ा ग ि त ् व ा र ् थ म ् |
सहमतम्	स ह म त म ् |
सहयोगसंवर्द्धने	स ह य ो ग स ं व र ् द ् ध न े |
सहयोगिदलानाम्	स ह य ो ग ि द ल ा न ा म ् |
सहरसादरभंगापश्चिमचंपारणनालंदाजनपदैः	स ह र स ा द र भ ं ग ा प श ् च ि म च ं प ा र ण न ा ल ं द ा ज न प द ै ः |
सहसैव	स ह स ै व |
सहस्र	स ह स ् र |
सहस्रकोटि	स ह स ् र क ो ट ि |
सहस्रमिता	स ह स ् र म ि त ा |
सहस्राणि	स ह स ् र ा ण ि |
सहस्राधिकाः	स ह स ् र ा ध ि क ा ः |
सहस्राधिकैक	स ह स ् र ा ध ि क ै क |
सहस्र्	स ह स ् र ् |
सहारनपुरजनपदे	स ह ा र न प ु र ज न प द े |
सहारनपुरस्य	स ह ा र न प ु र स ् य |
सहारनपुरे	स ह ा र न प ु र े |
सहैव	स ह ै व |
सा	स ा |
सांप्रदायिक्हिंसाविषयं	स ा ं प ् र द ा य ि क ् ह ि ं स ा व ि ष य ं |
सांसदाः	स ा ं स द ा ः |
सांसदादर्शग्रामयोजनान्तर्गतं	स ा ं स द ा द र ् श ग ् र ा म य ो ज न ा न ् त र ् ग त ं |
सांसदानां	स ा ं स द ा न ा ं |
साइना	स ा इ न ा |
साकं	स ा क ं |
साकमपि	स ा क म प ि |
साकम्	स ा क म ् |
साच्	स ा च ् |
साधकानां	स ा ध क ा न ा ं |
साधनकाः	स ा ध न क ा ः |
साधनभूतानि	स ा ध न भ ू त ा न ि |
साधनयुक्ताः	स ा ध न य ु क ् त ा ः |
साध्यं	स ा ध ् य ं |
सापि	स ा प ि |
सापेक्षया	स ा प े क ् ष य ा |
साफल्य	स ा फ ल ् य |
साफ़ल्येन	स ा फ ़ ल ् य े न |
सामं	स ा म ं |
सामग्रि	स ा म ग ् र ि |
सामञ्जस्यं	स ा म ञ ् ज स ् य ं |
सामन्यत	स ा म न ् य त |
सामयाचारिकः	स ा म य ा च ा र ि क ः |
सामयाचारिकान्	स ा म य ा च ा र ि क ा न ् |
सामर्थ्यं	स ा म र ् थ ् य ं |
सामाजिक	स ा म ा ज ि क |
सामाजिकवैद्युतान्तर्जाले	स ा म ा ज ि क व ै द ् य ु त ा न ् त र ् ज ा ल े |
सामाजिकव्यवस्था	स ा म ा ज ि क व ् य व स ् थ ा |
सामाजिकी	स ा म ा ज ि क ी |
सामान्य	स ा म ा न ् य |
सामान्यतः	स ा म ा न ् य त ः |
सामायाचारिकान्	स ा म ा य ा च ा र ि क ा न ् |
सामूहिकबलात्कृतिहत्याप्रकरणस्य	स ा म ू ह ि क ब ल ा त ् क ृ त ि ह त ् य ा प ् र क र ण स ् य |
साम्प्रतं	स ा म ् प ् र त ं |
साम्प्रतमपि	स ा म ् प ् र त म प ि |
साम्प्रतिकीम्	स ा म ् प ् र त ि क ी म ् |
साम्प्रदायिकोग्रवादि	स ा म ् प ् र द ा य ि क ो ग ् र व ा द ि |
सायं	स ा य ं |
सायंकाल	स ा य ं क ा ल |
सायंकाले	स ा य ं क ा ल े |
सायणाचार्याः	स ा य ण ा च ा र ् य ा ः |
सायणाचार्येणापि	स ा य ण ा च ा र ् य े ण ा प ि |
सायणात्	स ा य ण ा त ् |
सायम्	स ा य म ् |
सारसङ्ग्रहबूताः	स ा र स ङ ् ग ् र ह ब ू त ा ः |
सारस्वत	स ा र स ् व त |
सार्कइतिदक्षिणेशियाक्षेत्रीयसहयोगसंघटनस्य	स ा र ् क इ त ि द क ् ष ि ण े श ि य ा क ् ष े त ् र ी य स ह य ो ग स ं घ ट न स ् य |
सार्कइतिदक्षिणैशिया	स ा र ् क इ त ि द क ् ष ि ण ै श ि य ा |
सार्कशिखरसम्मेलने	स ा र ् क श ि ख र स म ् म े ल न े |
सार्कसंयोगक्षेत्रान्तर्गतं	स ा र ् क स ं य ो ग क ् ष े त ् र ा न ् त र ् ग त ं |
सार्धं	स ा र ् ध ं |
सार्धद्विलक्षरूप्यकमिता	स ा र ् ध द ् व ि ल क ् ष र ू प ् य क म ि त ा |
सार्धाष्ट	स ा र ् ध ा ष ् ट |
सार्धैक	स ा र ् ध ै क |
सार्वजनिकवैयक्तिकसहभागित्वस्य	स ा र ् व ज न ि क व ै य क ् त ि क स ह भ ा ग ि त ् व स ् य |
सार्वजनिक्	स ा र ् व ज न ि क ् |
सालवृक्षः	स ा ल व ृ क ् ष ः |
सावहितीकृताः	स ा व ह ि त ी क ृ त ा ः |
सावादीत्	स ा व ा द ी त ् |
साहाय्य	स ा ह ा य ् य |
साहाय्यम्	स ा ह ा य ् य म ् |
साहाय्यार्थं	स ा ह ा य ् य ा र ् थ ं |
साहाय्योद्धार	स ा ह ा य ् य ो द ् ध ा र |
सिंगः	स ि ं ग ः |
सिंगहूडा	स ि ं ग ह ू ड ा |
सिंगेन	स ि ं ग े न |
सिंहः	स ि ं ह ः |
सिंहस्य	स ि ं ह स ् य |
सिंहे	स ि ं ह े |
सिंहेन	स ि ं ह े न |
सिंहो	स ि ं ह ो |
सिख्	स ि ख ् |
सिद्ध	स ि द ् ध |
सिद्धमपि	स ि द ् ध म प ि |
सिद्धमेव	स ि द ् ध म े व |
सिद्ध्यति	स ि द ् ध ् य त ि |
सिमोनाहालेपं	स ि म ो न ा ह ा ल े प ं |
सिम्नि	स ि म ् न ि |
सिल्चर्	स ि ल ् च र ् |
सीमन्त	स ी म न ् त |
सीमवर्तिजनपदे	स ी म व र ् त ि ज न प द े |
सीमा	स ी म ा |
सीमानं	स ी म ा न ं |
सीमानिकटस्थयोः	स ी म ा न ि क ट स ् थ य ो ः |
सीमान्ध्रक्षेत्रीयाणां	स ी म ा न ् ध ् र क ् ष े त ् र ी य ा ण ा ं |
सीमासुरक्षाधिकारिणः	स ी म ा स ु र क ् ष ा ध ि क ा र ि ण ः |
सीमासुरक्षाबलानि	स ी म ा स ु र क ् ष ा ब ल ा न ि |
सीम्नि	स ी म ् न ि |
सीरिया	स ी र ि य ा |
सीरियाइराक	स ी र ि य ा इ र ा क |
सीसैट्समस्या	स ी स ै ट ् स म स ् य ा |
सुंसूचितम्	स ु ं स ू च ि त म ् |
सुकरां	स ु क र ा ं |
सुखं	स ु ख ं |
सुखी	स ु ख ी |
सुखेन	स ु ख े न |
सुचारूसंचालनं	स ु च ा र ू स ं च ा ल न ं |
सुचारूसंचालनार्थं	स ु च ा र ू स ं च ा ल न ा र ् थ ं |
सुजाता	स ु ज ा त ा |
सुतरां	स ु त र ा ं |
सुत्रे	स ु त ् र े |
सुदीप्तसेनं	स ु द ी प ् त स े न ं |
सुदूरं	स ु द ू र ं |
सुदृढ	स ु द ृ ढ |
सुदृढसुरक्षा	स ु द ृ ढ स ु र क ् ष ा |
सुदृढसुरक्षाव्यवस्थायाम्	स ु द ृ ढ स ु र क ् ष ा व ् य व स ् थ ा य ा म ् |
सुनिश्चेतुं	स ु न ि श ् च े त ु ं |
सुप्रतिष्ठितमभवत्	स ु प ् र त ि ष ् ठ ि त म भ व त ् |
सुब्रह्मण्यम्	स ु ब ् र ह ् म ण ् य म ् |
सुमित्रामहाजनः	स ु म ि त ् र ा म ह ा ज न ः |
सुमित्रामहाजनवर्याम्	स ु म ि त ् र ा म ह ा ज न व र ् य ा म ् |
सुरक्	स ु र क ् |
सुरक्षा	स ु र क ् ष ा |
सुरक्षाकारणैः	स ु र क ् ष ा क ा र ण ै ः |
सुरक्षायाः	स ु र क ् ष ा य ा ः |
सुरक्षायुक्तद्वारान्वीक्षितुम्	स ु र क ् ष ा य ु क ् त द ् व ा र ा न ् व ी क ् ष ि त ु म ् |
सुरक्षिततया	स ु र क ् ष ि त त य ा |
सुवर्ण	स ु व र ् ण |
सुवर्णकाराय	स ु व र ् ण क ा र ा य |
सुवर्णपदकं	स ु व र ् ण प द क ं |
सुशासनं	स ु श ा स न ं |
सुशासनबाधिकाः	स ु श ा स न ब ा ध ि क ा ः |
सुषमा	स ु ष म ा |
सुषमास्वराजं	स ु ष म ा स ् व र ा ज ं |
सुषमास्वराजः	स ु ष म ा स ् व र ा ज ः |
सुषमास्वराजमहाभागया	स ु ष म ा स ् व र ा ज म ह ा भ ा ग य ा |
सुषुप्तस्य	स ु ष ु प ् त स ् य |
सुष्टमित्येव	स ु ष ् ट म ि त ् य े व |
सुष्टिक्रमे	स ु ष ् ट ि क ् र म े |
सुष्टिरववत्	स ु ष ् ट ि र व व त ् |
सुष्टिविषये	स ु ष ् ट ि व ि ष य े |
सुष्ठु	स ु ष ् ठ ु |
सुहृत्	स ु ह ृ त ् |
सुहृदः	स ु ह ृ द ः |
सूक्षशरीरम्	स ू क ् ष श र ी र म ् |
सूचना	स ू च न ा |
सूचनात्	स ू च न ा त ् |
सूचनैका	स ू च न ै क ा |
सूचयन्	स ू च य न ् |
सूचयन्ति	स ू च य न ् त ि |
सूचितं	स ू च ि त ं |
सूचितमस्ति	स ू च ि त म स ् त ि |
सूचितम्	स ू च ि त म ् |
सूचीं	स ू च ी ं |
सूचीमेकां	स ू च ी म े क ा ं |
सूच्यते	स ू च ् य त े |
सूत्र	स ू त ् र |
सूत्रं	स ू त ् र ं |
सूत्रकरः	स ू त ् र क र ः |
सूत्रकारः	स ू त ् र क ा र ः |
सूत्रकाराणाञ्च	स ू त ् र क ा र ा ण ा ञ ् च |
सूत्रकारेण	स ू त ् र क ा र े ण |
सूत्रकारैः	स ू त ् र क ा र ै ः |
सूत्रकारैश्च	स ू त ् र क ा र ै श ् च |
सूत्रमस्ति	स ू त ् र म स ् त ि |
सूत्रम्	स ू त ् र म ् |
सूत्रयन्नस्ति	स ू त ् र य न ् न स ् त ि |
सूत्रयामास	स ू त ् र य ा म ा स |
सूत्रवत्	स ू त ् र व त ् |
सूत्राणां	स ू त ् र ा ण ा ं |
सूत्राणि	स ू त ् र ा ण ि |
सूत्रितमस्ति	स ू त ् र ि त म स ् त ि |
सूत्रितवान्	स ू त ् र ि त व ा न ् |
सूत्रितानि	स ू त ् र ि त ा न ि |
सूत्रे	स ू त ् र े |
सूत्रेण	स ू त ् र े ण |
सूत्रेपि	स ू त ् र े प ि |
सूत्रेषु	स ू त ् र े ष ु |
सूर्येण	स ू र ् य े ण |
सृजत	स ृ ज त |
सृज्यते	स ृ ज ् य त े |
सृज्यन्ते	स ृ ज ् य न ् त े |
सृष्टं	स ृ ष ् ट ं |
सृष्टि	स ृ ष ् ट ि |
सृष्टिः	स ृ ष ् ट ि ः |
सृष्टिक्रम	स ृ ष ् ट ि क ् र म |
सृष्टिक्रमः	स ृ ष ् ट ि क ् र म ः |
सृष्टिक्रमे	स ृ ष ् ट ि क ् र म े |
सृष्टिजा	स ृ ष ् ट ि ज ा |
सृष्टिरक्षणाय	स ृ ष ् ट ि र क ् ष ण ा य |
सृष्टिरुच्यते	स ृ ष ् ट ि र ु च ् य त े |
सृष्टिविचारे	स ृ ष ् ट ि व ि च ा र े |
सृष्टी	स ृ ष ् ट ी |
सृष्टेस्य	स ृ ष ् ट े स ् य |
सृष्टौ	स ृ ष ् ट ौ |
सेतु	स े त ु |
सेत्स्यति	स े त ् स ् य त ि |
सेनः	स े न ः |
सेनाः	स े न ा ः |
सेनादलयोः	स े न ा द ल य ो ः |
सेनाध्यक्षः	स े न ा ध ् य क ् ष ः |
सेनाध्यक्षत्वेन	स े न ा ध ् य क ् ष त ् व े न |
सेनाध्यक्षेण	स े न ा ध ् य क ् ष े ण |
सेनाध्यक्षो	स े न ा ध ् य क ् ष ो |
सेनाभि	स े न ा भ ि |
सेनाभिः	स े न ा भ ि ः |
सेनायाः	स े न ा य ा ः |
सेनैकांशान्	स े न ै क ा ं श ा न ् |
सेनोपप्रमुखस्य	स े न ो प प ् र म ु ख स ् य |
सेवनीयास्ति	स े व न ी य ा स ् त ि |
सेवा	स े व ा |
सेवाः	स े व ा ः |
सेवाधिकारिण्याः	स े व ा ध ि क ा र ि ण ् य ा ः |
सेवापरीक्षाणाम्	स े व ा प र ी क ् ष ा ण ा म ् |
सेवाप्रभागतः	स े व ा प ् र भ ा ग त ः |
सेविकायाः	स े व ि क ा य ा ः |
सैनिकाः	स ै न ि क ा ः |
सैनिकेः	स ै न ि क े ः |
सैनिकैः	स ै न ि क ै ः |
सैन्य	स ै न ् य |
सैन्यबलसंचालित्विद्यालये	स ै न ् य ब ल स ं च ा ल ि त ् व ि द ् य ा ल य े |
सैन्याधिकारी	स ै न ् य ा ध ि क ा र ी |
सैन्यास्थानकात्	स ै न ् य ा स ् थ ा न क ा त ् |
सैयद्	स ै य द ् |
सैव	स ै व |
सोत्साहं	स ो त ् स ा ह ं |
सोत्साहम्	स ो त ् स ा ह म ् |
सोद्देशं	स ो द ् द े श ं |
सोनिया	स ो न ि य ा |
सोनियागान्धी	स ो न ि य ा ग ा न ् ध ी |
सोपचारं	स ो प च ा र ं |
सोप्यर्थः	स ो प ् य र ् थ ः |
सोम	स ो म |
सोमः	स ो म ः |
सोमक्रयात्मकाश्च	स ो म क ् र य ा त ् म क ा श ् च |
सोमदेवतात्मकाः	स ो म द े व त ा त ् म क ा ः |
सोमरूपेण	स ो म र ू प े ण |
सोमवासरे	स ो म व ा स र े |
सोमस्तु	स ो म स ् त ु |
सोमो	स ो म ो |
सोमोभूत्वा	स ो म ो भ ू त ् व ा |
सोल्लासं	स ो ल ् ल ा स ं |
सोसांसि	स ो स ा ं स ि |
सौत्रामणि	स ौ त ् र ा म ण ि |
सौप्रस्थानिकसम्माने	स ौ प ् र स ् थ ा न ि क स म ् म ा न े |
सौम्य	स ौ म ् य |
सौवर्णं	स ौ व र ् ण ं |
सौवर्णानि	स ौ व र ् ण ा न ि |
सौविध्यं	स ौ व ि ध ् य ं |
सौविध्यानि	स ौ व ि ध ् य ा न ि |
सौहार्दपूर्णं	स ौ ह ा र ् द प ू र ् ण ं |
सौहार्दभावं	स ौ ह ा र ् द भ ा व ं |
स्	स ् |
स्टेट	स ् ट े ट |
स्तः	स ् त ः |
स्थगितम्	स ् थ ग ि त म ् |
स्थगिता	स ् थ ग ि त ा |
स्थगितीकृतम्	स ् थ ग ि त ी क ृ त म ् |
स्थले	स ् थ ल े |
स्थलेषु	स ् थ ल े ष ु |
स्थातुं	स ् थ ा त ु ं |
स्थात्रं	स ् थ ा त ् र ं |
स्थात्राणि	स ् थ ा त ् र ा ण ि |
स्थात्राधीनक्षेत्रेषु	स ् थ ा त ् र ा ध ी न क ् ष े त ् र े ष ु |
स्थाद्	स ् थ ा द ् |
स्थान	स ् थ ा न |
स्थानं	स ् थ ा न ं |
स्थानकद्वयं	स ् थ ा न क द ् व य ं |
स्थानीय	स ् थ ा न ी य |
स्थाने	स ् थ ा न े |
स्थानेषु	स ् थ ा न े ष ु |
स्थापना	स ् थ ा प न ा |
स्थापितास्ति	स ् थ ा प ि त ा स ् त ि |
स्थापितेषु	स ् थ ा प ि त े ष ु |
स्थापितैः	स ् थ ा प ि त ै ः |
स्थापितौ	स ् थ ा प ि त ौ |
स्थायि	स ् थ ा य ि |
स्थास्यति	स ् थ ा स ् य त ि |
स्थितः	स ् थ ि त ः |
स्थिति	स ् थ ि त ि |
स्थितिं	स ् थ ि त ि ं |
स्थितिः	स ् थ ि त ि ः |
स्थितिपरिपालनं	स ् थ ि त ि प र ि प ा ल न ं |
स्थितिम्	स ् थ ि त ि म ् |
स्थितिेः	स ् थ ि त ि े ः |
स्थितेः	स ् थ ि त े ः |
स्थितौ	स ् थ ि त ौ |
स्थिरतां	स ् थ ि र त ा ं |
स्थूलगजः	स ् थ ू ल ग ज ः |
स्थूलतया	स ् थ ू ल त य ा |
स्नातकपाठ्यक्रमम्	स ् न ा त क प ा ठ ् य क ् र म म ् |
स्पर्धा	स ् प र ् ध ा |
स्पर्धापुरुषो	स ् प र ् ध ा प ु र ु ष ो |
स्पर्धामालिकायाः	स ् प र ् ध ा म ा ल ि क ा य ा ः |
स्पर्धायां	स ् प र ् ध ा य ा ं |
स्पर्धायाम्	स ् प र ् ध ा य ा म ् |
स्पर्धालुप्रत्याशिनां	स ् प र ् ध ा ल ु प ् र त ् य ा श ि न ा ं |
स्पर्धालुप्रत्याशिभिरत्रः	स ् प र ् ध ा ल ु प ् र त ् य ा श ि भ ि र त ् र ः |
स्पर्धिष्यते	स ् प र ् ध ि ष ् य त े |
स्पर्धेयं	स ् प र ् ध े य ं |
स्पष्टं	स ् प ष ् ट ं |
स्पष्टतया	स ् प ष ् ट त य ा |
स्पष्टता	स ् प ष ् ट त ा |
स्पष्टीकरणं	स ् प ष ् ट ी क र ण ं |
स्पष्ट्	स ् प ष ् ट ् |
स्पेनदेशीयै	स ् प े न द े श ी य ै |
स्म	स ् म |
स्मरति	स ् म र त ि |
स्मृति	स ् म ृ त ि |
स्मृत्यन्तर	स ् म ृ त ् य न ् त र |
स्म्भाषणशिविराणि	स ् म ् भ ा ष ण श ि व ि र ा ण ि |
स्यात्	स ् य ा त ् |
स्रोतांसि	स ् र ो त ा ं स ि |
स्रोतानां	स ् र ो त ा न ा ं |
स्रोतोभिः	स ् र ो त ो भ ि ः |
स्व	स ् व |
स्वकर्मणा	स ् व क र ् म ण ा |
स्वकारण	स ् व क ा र ण |
स्वकाले	स ् व क ा ल े |
स्वच्छताव्यवस्था	स ् व च ् छ त ा व ् य व स ् थ ा |
स्वच्छभारताभियानं	स ् व च ् छ भ ा र त ा भ ि य ा न ं |
स्वच्छभारताभियानस्य	स ् व च ् छ भ ा र त ा भ ि य ा न स ् य |
स्वतन्त्रं	स ् व त न ् त ् र ं |
स्वतन्त्रतादिवसं	स ् व त न ् त ् र त ा द ि व स ं |
स्वतन्त्रतादिवसव	स ् व त न ् त ् र त ा द ि व स व |
स्वतन्त्राणि	स ् व त न ् त ् र ा ण ि |
स्वत्वत्यागपूर्वकं	स ् व त ् व त ् य ा ग प ू र ् व क ं |
स्वदेशं	स ् व द े श ं |
स्वदेशप्रत्यागमनाय	स ् व द े श प ् र त ् य ा ग म न ा य |
स्वदेशप्रत्यानयनकर्म	स ् व द े श प ् र त ् य ा न य न क र ् म |
स्वपदं	स ् व प द ं |
स्वपदगोपनीयतायै	स ् व प द ग ो प न ी य त ा य ै |
स्वपदम्	स ् व प द म ् |
स्वपदे	स ् व प द े |
स्वपदेव	स ् व प द े व |
स्वमूल	स ् व म ू ल |
स्वयं	स ् व य ं |
स्वराज	स ् व र ा ज |
स्वराजः	स ् व र ा ज ः |
स्वराजेन	स ् व र ा ज े न |
स्वरूपं	स ् व र ू प ं |
स्वरूपः	स ् व र ू प ः |
स्वरूपभूत	स ् व र ू प भ ू त |
स्वशक्त्या	स ् व श क ् त ् य ा |
स्वस्वप्रतिभाप्रदर्शनं	स ् व स ् व प ् र त ि भ ा प ् र द र ् श न ं |
स्वहस्ते	स ् व ह स ् त े |
स्वात्मानं	स ् व ा त ् म ा न ं |
स्वास्थ्यलाभार्थं	स ् व ा स ् थ ् य ल ा भ ा र ् थ ं |
स्विट्ज़रलैण्डः	स ् व ि ट ् ज ़ र ल ै ण ् ड ः |
स्विस्प्रशासनस्य	स ् व ि स ् प ् र श ा स न स ् य |
स्वीकरोति	स ् व ी क र ो त ि |
स्वीकृतवान्	स ् व ी क ृ त व ा न ् |
स्वीकृतास्ति	स ् व ी क ृ त ा स ् त ि |
स्वीकृतिः	स ् व ी क ृ त ि ः |
स्वीकृत्य	स ् व ी क ृ त ् य |
स्वीक्रियते	स ् व ी क ् र ि य त े |
स्वीय	स ् व ी य |
स्वीयं	स ् व ी य ं |
स्वीयदलाय	स ् व ी य द ल ा य |
स्वीयनेतृत्वेन	स ् व ी य न े त ृ त ् व े न |
स्वीयप्रतिद्वन्द्विनीं	स ् व ी य प ् र त ि द ् व न ् द ् व ि न ी ं |
स्वीयप्रथमे	स ् व ी य प ् र थ म े |
स्वीयभारत	स ् व ी य भ ा र त |
स्वीययात्रावधौ	स ् व ी य य ा त ् र ा व ध ौ |
स्वीयसन्देशे	स ् व ी य स न ् द े श े |
स्वीयसार्वजनिक्वक्तव्यस्य	स ् व ी य स ा र ् व ज न ि क ् व क ् त व ् य स ् य |
स्वीयस्वतन्त्रतायाः	स ् व ी य स ् व त न ् त ् र त ा य ा ः |
स्वीया	स ् व ी य ा |
स्वीयां	स ् व ी य ा ं |
स्वीयाध्ययन	स ् व ी य ा ध ् य य न |
स्वीयाम्	स ् व ी य ा म ् |
स्वीयावासे	स ् व ी य ा व ा स े |
स्वीयाष्टक्रीडकाणां	स ् व ी य ा ष ् ट क ् र ी ड क ा ण ा ं |
स्वीये	स ् व ी य े |
स्वीयोत्कृष्टविजयार्थं	स ् व ी य ो त ् क ृ ष ् ट व ि ज य ा र ् थ ं |
स्वेच्छा	स ् व े च ् छ ा |
हतः	ह त ः |
हत्थं	ह त ् थ ं |
हत्यायाः	ह त ् य ा य ा ः |
हत्यासंदिग्धस्य	ह त ् य ा स ं द ि ग ् ध स ् य |
हत्वा	ह त ् व ा |
हनोईनगरीं	ह न ो ई न ग र ी ं |
हरदत्त	ह र द त ् त |
हरियाणा	ह र ि य ा ण ा |
हरियाणामहाराष्ट्रराज्ययोः	ह र ि य ा ण ा म ह ा र ा ष ् ट ् र र ा ज ् य य ो ः |
हरियाणाराज्ये	ह र ि य ा ण ा र ा ज ् य े |
हरियाणाविद्युन्मन्त्री	ह र ि य ा ण ा व ि द ् य ु न ् म न ् त ् र ी |
हविः	ह व ि ः |
हविर्यज्ञ	ह व ि र ् य ज ् ञ |
हस्तक्षेपो	ह स ् त क ् ष े प ो |
हस्ताक्षरैः	ह स ् त ा क ् ष र ै ः |
हामरेनरक्ष्यधीक्षकस्य	ह ा म र े न र क ् ष ् य ध ी क ् ष क स ् य |
हामिदअन्सारी	ह ा म ि द अ न ् स ा र ी |
हि	ह ि |
हिंस	ह ि ं स |
हिंसा	ह ि ं स ा |
हिंसामभिलक्ष्य	ह ि ं स ा म भ ि ल क ् ष ् य |
हिंस्रघटनायां	ह ि ं स ् र घ ट न ा य ा ं |
हिज़्बुलमुज़ाहिद्दीन	ह ि ज ़ ् ब ु ल म ु ज ़ ा ह ि द ् द ी न |
हित	ह ि त |
हितं	ह ि त ं |
हिमाचलप्रदेशे	ह ि म ा च ल प ् र द े श े |
हिमाचल्	ह ि म ा च ल ् |
हिरण्यं	ह ि र ण ् य ं |
हिरण्यकेशी	ह ि र ण ् य क े श ी |
हिरण्यगर्भ	ह ि र ण ् य ग र ् भ |
हिरण्यगर्भः	ह ि र ण ् य ग र ् भ ः |
हिरण्यगर्भणः	ह ि र ण ् य ग र ् भ ण ः |
हिरण्यगर्भरूपय	ह ि र ण ् य ग र ् भ र ू प य |
हिरण्यगर्भरूपस्सन्	ह ि र ण ् य ग र ् भ र ू प स ् स न ् |
हिरण्यगर्भात्	ह ि र ण ् य ग र ् भ ा त ् |
हिरण्यगर्भो	ह ि र ण ् य ग र ् भ ो |
हिरन्	ह ि र न ् |
हिरन्य	ह ि र न ् य |
हिरन्यः	ह ि र न ् य ः |
हूयते	ह ू य त े |
हूयन्ते	ह ू य न ् त े |
हेतुः	ह े त ु ः |
हेतुभूतानि	ह े त ु भ ू त ा न ि |
हेतोः	ह े त ो ः |
हेमन्त	ह े म न ् त |
हेरात्	ह े र ा त ् |
हेह्रंजपन्की	ह े ह ् र ं ज प न ् क ी |
हैदराबादतो	ह ै द र ा ब ा द त ो |
हैद्राबादं	ह ै द ् र ा ब ा द ं |
हॉकीक्रीडकाः	ह ॉ क ी क ् र ी ड क ा ः |
हॉकीविश्वचषकमालिकायाः	ह ॉ क ी व ि श ् व च ष क म ा ल ि क ा य ा ः |
हॉकीस्पर्धायां	ह ॉ क ी स ् प र ् ध ा य ा ं |
होत्रमन्त्राण्	ह ो त ् र म न ् त ् र ा ण ् |
होमद्रव्य	ह ो म द ् र व ् य |
होमे	ह ो म े |
होराचतुष्टयात्मकं	ह ो र ा च त ु ष ् ट य ा त ् म क ं |
होरावधये	ह ो र ा व ध य े |
होरावधिं	ह ो र ा व ध ि ं |
होरावधिकं	ह ो र ा व ध ि क ं |
होशियार्पुरजनपदन्यायालयो	ह ो श ि य ा र ् प ु र ज न प द न ् य ा य ा ल य ो |
ह्यः	ह ् य ः |
